=======[thaumcraft]=======
WARP | thaumcraft | Warp, Flux and all things bad | 1 | [None] | [None]
RESEARCH | thaumcraft | Research | 1 | [None] | [None]
ENCHANT | thaumcraft | Enchantments | 1 | [None] | [None]
NODES | thaumcraft | Auras and Nodes | 1 | [None] | [None]
RESEARCHDUPE | thaumcraft | Research Duplication | 3 | [RESEARCHER2] | [None]
ORE | thaumcraft | Ores | 1 | [None] | [None]
ASPECTS | thaumcraft | Aspects of Magic | 1 | [None] | [None]
KNOWFRAG | thaumcraft | Knowledge Fragments | 1 | [RESEARCH] | [None]
ELDRITCHMINOR | thaumcraft | Eldritch Epiphany | 3 | [RESEARCHER2] | [RESEARCHER1, INFUSION]
RESEARCHER2 | thaumcraft | Research Mastery | 2 | [RESEARCHER1] | [None]
CRIMSON | thaumcraft | The Crimson Cult | 1 | [None] | [None]
NODEJAR | thaumcraft | Node in a Jar | 3 | [NODEPRESERVE] | [None]
RESEARCHER1 | thaumcraft | Research Expertise | 1 | [RESEARCH] | [None]
NODECATALYZATION | thaumcraft | Node Catalyzation | 3 | [NODEJAR, NODETAPPER2] | [JARLABEL]
NODETAPPER2 | thaumcraft | Master Node Tapping | 2 | [NODETAPPER1] | [None]
DECONSTRUCTOR | thaumcraft | Deconstruction table | 1 | [RESEARCHER1] | [None]
NODETAPPER1 | thaumcraft | Advanced Node Tapping | 2 | [NODES] | [None]
THAUMONOMICON | thaumcraft | Thaumonomicon | 1 | [RESEARCH] | [None]
PLANTS | thaumcraft | Plants & Trees | 1 | [None] | [None]
NODEPRESERVE | thaumcraft | Node Preserver | 2 | [NODETAPPER1] | [None]
PECH | thaumcraft | The Pech | 1 | [None] | [None]

=======[thaumcraft]=======
NODESTABILIZER | thaumcraft | Node Stabilizer | 1 | [NODEPRESERVE] | [None]
VAMPBAT | thaumcraft | Tier 5 Upgrade: Vampire Bats  | 1 | [FOCUSHELLBAT] | [FOCALMANIPULATION]
FOCUSEXCAVATION | thaumcraft | Wand Focus: Excavation | 2 | [FOCUSFIRE] | [None]
FOCUSHELLBAT | thaumcraft | Wand Focus: Nine Hells | 2 | [None] | [FOCUSFIRE, INFUSION]
VISCHARGERELAY | thaumcraft | Vis Charging Relay | 2 | [VISPOWER, WANDPED] | [ROD_greatwood]
ROD_ice | thaumcraft | Icy Wand Core | 2 | [ROD_greatwood, INFUSION] | [None]
ROD_reed | thaumcraft | Reed Wand Core | 2 | [ROD_greatwood, INFUSION] | [None]
ROD_greatwood_staff | thaumcraft | Magic Staves | 1 | [ROD_silverwood] | [None]
CAP_alfheimManasteel | thaumcraft | Manasteel Wand Caps | 1 | [CAP_gold] | [None]
ROD_silverwood_staff | thaumcraft | Silverwood Staff Core | 3 | [ROD_silverwood] | [ROD_greatwood_staff]
CAP_alfheimElementium | thaumcraft | Elementium Wand Caps | 1 | [CAP_gold] | [None]
VISAMULET | thaumcraft | Vis Storage | 2 | [WANDPED] | [None]
CAP_gold | thaumcraft | Gold Wand Caps | 1 | [BASICTHAUMATURGY] | [None]
VISPOWER | thaumcraft | Harnessing Vis | 2 | [NODESTABILIZER] | [None]
FOCUSPOUCH | thaumcraft | Focus Pouch | 1 | [FOCUSFIRE] | [None]
ROD_reed_staff | thaumcraft | Reed Staff Core | 2 | [ROD_reed] | [ROD_greatwood_staff]
FOCUSSHOCK | thaumcraft | Wand Focus: Shock | 1 | [FOCUSFIRE] | [None]
CAP_silver | thaumcraft | Silver Wand Caps | 1 | [CAP_gold, INFUSION] | [None]
PUMPKIFICTION | thaumcraft | Wand Focus: Pumpkifiction | 3 | [FOCUSWARDING] | [None]
ROD_obsidian | thaumcraft | Obsidian Wand Core | 2 | [ROD_greatwood, INFUSION] | [None]
ROD_greatwood | thaumcraft | Greatwood Wand Core | 1 | [BASICTHAUMATURGY] | [None]
ROD_bone_staff | thaumcraft | Bone Staff Core | 2 | [ROD_bone] | [ROD_greatwood_staff]
ROD_alfheimLivingwood | thaumcraft | Livingwood Wand Core | 1 | [ROD_greatwood] | [None]
ROD_blaze_staff | thaumcraft | Blaze Rod Staff Core | 2 | [ROD_blaze] | [ROD_greatwood_staff]
WANDPEDFOC | thaumcraft | Compound Recharge Focus | 3 | [WANDPED] | [None]
ROD_bone | thaumcraft | Bone Wand Core | 2 | [ROD_greatwood, INFUSION] | [None]
BASICTHAUMATURGY | thaumcraft | Basic Wand Craft | 1 | [None] | [None]
SCEPTRE | thaumcraft | Crafting Scepters | 3 | [ROD_silverwood] | [None]
ROD_quartz_staff | thaumcraft | Quartz Staff Core | 2 | [ROD_quartz] | [ROD_greatwood_staff]
NODESTABILIZERADV | thaumcraft | Advanced Node Stabilizer | 2 | [NODESTABILIZER] | [None]
CAP_alfheimMauftrium | thaumcraft | Mauftrium Wand Caps | 3 | [CAP_void] | [None]
CAP_alfheimElvorium | thaumcraft | Elvorium Wand Caps | 2 | [CAP_thaumium] | [None]
CAP_alfheimTerrasteel | thaumcraft | Terrasteel Wand Caps | 2 | [CAP_thaumium] | [None]
FOCUSFROST | thaumcraft | Wand Focus: Frost | 1 | [FOCUSFIRE] | [None]
FOCALMANIPULATION | thaumcraft | Focal Manipulation  | 2 | [VISPOWER] | [INFUSION, FOCUSFIRE]
FOCUSFIRE | thaumcraft | Wand Foci | 1 | [BASICTHAUMATURGY] | [None]
ROD_silverwood | thaumcraft | Silverwood Wand Core | 3 | [ROD_greatwood, INFUSION] | [None]
ROD_alfheimSpiritual_staff | thaumcraft | Spiritual Staff Core | 2 | [ROD_silverwood] | [None]
CAP_copper | thaumcraft | Copper Wand Caps | 1 | [BASICTHAUMATURGY] | [None]
ROD_quartz | thaumcraft | Quartz Wand Core | 2 | [ROD_greatwood, INFUSION] | [None]
CAP_iron | thaumcraft | tc.research_name.CAP_iron | 0 | [None] | [None]
FOCUSWARDING | thaumcraft | Wand Focus: Warding | 3 | [FOCUSEXCAVATION, INFUSION] | [None]
FOCUSPORTABLEHOLE | thaumcraft | Wand Focus: Portable Hole | 2 | [FOCUSTRADE, INFUSION] | [None]
CAP_thaumium | thaumcraft | Thaumium Wand Caps | 2 | [CAP_gold, THAUMIUM, INFUSION] | [None]
ROD_wood | thaumcraft | tc.research_name.ROD_wood | 0 | [None] | [None]
ROD_blaze | thaumcraft | Blaze Rod Wand Core | 2 | [ROD_greatwood, INFUSION] | [None]
ROD_obsidian_staff | thaumcraft | Obsidian Staff Core | 2 | [ROD_obsidian] | [ROD_greatwood_staff]
FOCUSTRADE | thaumcraft | Wand Focus: Equal Trade | 2 | [FOCUSFIRE] | [None]
ROD_ice_staff | thaumcraft | Icy Staff Core | 2 | [ROD_ice] | [ROD_greatwood_staff]
WANDPED | thaumcraft | Wand Recharge Pedestal | 2 | [INFUSION, NODEPRESERVE, NODESTABILIZER] | [None]
ROD_alfheimDreamwood | thaumcraft | Dreamwood Wand Core | 2 | [ROD_greatwood] | [None]

=======[thaumcraft]=======
ALUMENTUM | thaumcraft | Alumentum | 1 | [CRUCIBLE] | [None]
BATHSALTS | thaumcraft | Purifying Bath Salts | 2 | [ALCHEMICALMANUFACTURE] | [None]
CRUCIBLE | thaumcraft | Basic Alchemy | 1 | [None] | [None]
ENTROPICPROCESSING | thaumcraft | Entropic Processing | 1 | [ALCHEMICALDUPLICATION] | [None]
TRANSIRON | thaumcraft | Metal Transmutation | 1 | [THAUMIUM] | [None]
THAUMATORIUM | thaumcraft | Automated Alchemy | 3 | [CENTRIFUGE] | [None]
ALCHEMICALMANUFACTURE | thaumcraft | Alchemical Manufacture | 1 | [ALCHEMICALDUPLICATION] | [None]
LIQUIDDEATH | thaumcraft | Liquid Death | 2 | [ENTROPICPROCESSING] | [None]
TUBES | thaumcraft | Essentia Tubes | 1 | [DISTILESSENTIA] | [None]
TRANSTIN | thaumcraft | Tin Transmutation | 1 | [TRANSIRON] | [None]
SANESOAP | thaumcraft | Sanitizing Soap | 1 | [BATHSALTS] | [None]
WARPUPGRADE | thaumcraft | Warp Protection Upgrade | 2 | [ARCANESPA] | [None]
ETHEREALBLOOM | thaumcraft | Ethereal Bloom | 2 | [CRUCIBLE] | [None]
TALLOW | thaumcraft | Magic Tallow | 1 | [CRUCIBLE] | [None]
alfheimTRANSELEMENTIUM | thaumcraft | Elementium Transmutation | 1 | [TRANSIRON] | [None]
PURESILVER | thaumcraft | Silver Purification | 1 | [PUREIRON] | [None]
PURETIN | thaumcraft | Tin Purification | 1 | [PUREIRON] | [None]
TRANSCOPPER | thaumcraft | Copper Transmutation | 1 | [TRANSIRON] | [None]
ESSENTIACRYSTAL | thaumcraft | Essentia Crystallization  | 1 | [TUBES] | [None]
ARCANESPA | thaumcraft | Arcane Spa | 1 | [BATHSALTS] | [None]
CENTRIFUGE | thaumcraft | Alchemical Centrifuge | 2 | [TUBEFILTER] | [None]
TRANSSILVER | thaumcraft | Silver Transmutation | 1 | [TRANSIRON] | [None]
PUREIRON | thaumcraft | Metal Purification | 1 | [THAUMIUM] | [None]
ALCHEMICALDUPLICATION | thaumcraft | Alchemical Duplication | 1 | [TALLOW] | [None]
JARVOID | thaumcraft | Void Jar | 1 | [JARLABEL] | [None]
NITOR | thaumcraft | Nitor | 1 | [CRUCIBLE] | [None]
BOTTLETAINT | thaumcraft | Bottled Taint  | 2 | [ENTROPICPROCESSING] | [None]
PUREGOLD | thaumcraft | Gold Purification | 1 | [PUREIRON] | [None]
DISTILESSENTIA | thaumcraft | Essentia Distillation | 1 | [NITOR, ALUMENTUM] | [None]
PHIAL | thaumcraft | Glass Phial | 1 | [None] | [None]
TUBEFILTER | thaumcraft | Advanced Essentia Tubes | 2 | [TUBES] | [None]
PURELEAD | thaumcraft | Lead Purification | 1 | [PUREIRON] | [None]
alfheimPUREELEMENTIUM | thaumcraft | Elementium Purification | 1 | [PUREIRON] | [None]
THAUMIUM | thaumcraft | Magical Metallurgy | 1 | [CRUCIBLE] | [None]
TRANSLEAD | thaumcraft | Lead Transmutation | 1 | [TRANSIRON] | [None]
TRANSGOLD | thaumcraft | Gold Transmutation | 1 | [TRANSIRON] | [None]
PURECOPPER | thaumcraft | Copper Purification | 1 | [PUREIRON] | [None]
JARLABEL | thaumcraft | Warded Jars and Labels | 1 | [DISTILESSENTIA] | [None]

=======[thaumcraft]=======
RUNICEMERGENCY | thaumcraft | Amulet of Emergency Shielding | 2 | [RUNICARMOR] | [None]
GOGGLES | thaumcraft | Goggles of Revealing | 1 | [THAUMOMETER] | [None]
ENCHFABRIC | thaumcraft | Enchanted Fabric | 1 | [None] | [None]
ELEMENTALPICK | thaumcraft | Pickaxe of the Core | 2 | [THAUMIUM, INFUSION] | [None]
ELEMENTALAXE | thaumcraft | Axe of the Stream | 2 | [THAUMIUM, INFUSION] | [None]
TABLE | thaumcraft | Table | 1 | [None] | [None]
INFERNALFURNACE | thaumcraft | Infernal Furnace | 2 | [NITOR, ALUMENTUM] | [None]
BANNERS | thaumcraft | Banners  | 1 | [None] | [None]
ELEMENTALSHOVEL | thaumcraft | Shovel of the Earthmover | 2 | [THAUMIUM, INFUSION] | [None]
LEVITATOR | thaumcraft | Arcane Levitator | 1 | [NITOR] | [None]
HOVERGIRDLE | thaumcraft | Thaumostatic Girdle | 3 | [HOVERHARNESS] | [None]
WARDEDARCANA | thaumcraft | Warded Arcana | 2 | [THAUMIUM] | [None]
BASICARTIFACE | thaumcraft | Basic Artifacing | 1 | [None] | [None]
FLUXSCRUB | thaumcraft | Flux Scrubber  | 1 | [VISPOWER, BELLOWS, TUBES] | [INFUSION]
THAUMOMETER | thaumcraft | Thaumometer | 1 | [None] | [None]
BOOTSTRAVELLER | thaumcraft | Boots of the Traveler | 2 | [ENCHFABRIC, INFUSION] | [None]
RESTABLE | thaumcraft | Research Table | 1 | [TABLE] | [None]
MIRRORESSENTIA | thaumcraft | Essentia Mirrors | 2 | [MIRROR] | [None]
PRIMALARROW | thaumcraft | Primal Arrows | 2 | [BONEBOW] | [None]
ARCANEEAR | thaumcraft | Arcane Ear | 1 | [GOGGLES] | [None]
GRATE | thaumcraft | Item Grate | 1 | [None] | [None]
RUNICCHARGED | thaumcraft | Charged Ring of Shielding | 2 | [RUNICARMOR] | [None]
RUNICHEALING | thaumcraft | Revitalizing Ring of Shielding | 2 | [RUNICARMOR] | [None]
HOVERHARNESS | thaumcraft | Thaumostatic Harness | 3 | [BOOTSTRAVELLER] | [None]
MIRROR | thaumcraft | Mirror Magic | 2 | [INFUSION] | [None]
ALCHGRATE | thaumcraft | Alchemical Grate | 1 | [ADVALCHEMYFURNACE, HUNGRYCHEST, GRATE] | [None]
LAMPGROWTH | thaumcraft | Lamp of Growth | 2 | [ARCANELAMP, INFUSION] | [None]
MASKGRINNINGDEVIL | thaumcraft | Grinning Devil Faceplate | 2 | [ARMORFORTRESS] | [None]
ELEMENTALHOE | thaumcraft | Hoe of Growth | 2 | [THAUMIUM, INFUSION] | [None]
MIRRORHAND | thaumcraft | Magical Hand Mirror | 2 | [MIRROR] | [None]
ARCTABLE | thaumcraft | Arcane Worktable | 1 | [TABLE] | [None]
INFUSION | thaumcraft | Infusion | 2 | [DISTILESSENTIA] | [None]
SHIELDBAUBLES | thaumcraft | Baubles Stuff Shielding | 2 | [RUNICARMOR] | [None]
RUNICKINETIC | thaumcraft | Kinetic Girdle of Shielding | 2 | [RUNICARMOR] | [None]
PAVEWARD | thaumcraft | Paving Stone of Warding | 1 | [ARCANESTONE] | [None]
MASKANGRYGHOST | thaumcraft | Angry Ghost Faceplate | 2 | [ARMORFORTRESS] | [None]
MASKSIPPINGFIEND | thaumcraft | Sipping Fiend Faceplate | 2 | [ARMORFORTRESS] | [None]
ARCANELAMP | thaumcraft | Arcane Lamp | 1 | [NITOR] | [None]
ARMORFORTRESS | thaumcraft | Thaumium Fortress Armor | 2 | [THAUMIUM, INFUSIONENCHANTMENT] | [None]
BELLOWS | thaumcraft | Arcane Bellows | 1 | [INFERNALFURNACE] | [None]
HELMGOGGLES | thaumcraft | Helm of Revealing | 2 | [ARMORFORTRESS] | [GOGGLES]
RUNICARMOR | thaumcraft | Runic Shielding | 3 | [ENCHFABRIC] | [INFUSION]
RUNICAUGMENTATION | thaumcraft | Runic Shielding Augmentation | 1 | [RUNICARMOR] | [None]
LAMPFERTILITY | thaumcraft | Lamp of Fertility | 2 | [ARCANELAMP, INFUSION] | [None]
BONEBOW | thaumcraft | Bone Bow | 1 | [None] | [None]
ARCANESTONE | thaumcraft | Arcane Stone | 1 | [None] | [None]
SINSTONE | thaumcraft | Sinister Lodestone  | 1 | [GOGGLES] | [None]
ELEMENTALSWORD | thaumcraft | Sword of the Zephyr | 2 | [THAUMIUM, INFUSION] | [None]
PAVETRAVEL | thaumcraft | Paving Stone of Travel | 1 | [ARCANESTONE] | [None]
JARBRAIN | thaumcraft | Brain in a Jar | 2 | [INFUSION] | [None]
ARCANEBORE | thaumcraft | Arcane Bore | 2 | [FOCUSEXCAVATION, INFUSION] | [None]
INFUSIONENCHANTMENT | thaumcraft | Infusion Enchantment | 3 | [JARBRAIN] | [None]

=======[thaumcraft]=======
GOLEMCLAY | thaumcraft | Clay Golems | 2 | [GOLEMWOOD] | [None]
UPGRADEWATER | thaumcraft | Golem Upgrade: Water | 1 | [GOLEMBELL] | [None]
HUNGRYCHEST | thaumcraft | Hungry Chest | 1 | [None] | [None]
GOLEMTALLOW | thaumcraft | Tallow Golems | 2 | [GOLEMCLAY, TALLOW] | [None]
GOLEMWOOD | thaumcraft | Wooden Golems | 2 | [GOLEMSTRAW] | [None]
CORESANITIZE | thaumcraft | Golem Core: Sanitize | 3 | [COREUSE] | [None]
GOLEMFLESH | thaumcraft | Flesh Golems | 2 | [GOLEMWOOD] | [None]
UPGRADEEARTH | thaumcraft | Golem Upgrade: Earth | 1 | [GOLEMBELL] | [None]
TINYDART | thaumcraft | Golem Dart Launcher | 1 | [None] | [None]
UPGRADEFIRE | thaumcraft | Golem Upgrade: Fire | 1 | [GOLEMBELL] | [None]
UPGRADEENTROPY | thaumcraft | Golem Upgrade: Entropy | 1 | [GOLEMBELL] | [None]
COREUSE | thaumcraft | Golem Core: Use | 3 | [COREEMPTY, INFUSION] | [None]
TINYHAMMER | thaumcraft | Golem Mace | 1 | [None] | [None]
TRAVELTRUNK | thaumcraft | Traveling Trunk | 2 | [INFUSION, GOLEMWOOD] | [None]
TINYBOWTIE | thaumcraft | Tiny Bowties | 1 | [None] | [None]
GOLEMBELL | thaumcraft | Golemancer's Bell | 1 | [GOLEMSTRAW] | [None]
CORESORTING | thaumcraft | Golem Core: Sorting | 2 | [COREEMPTY, COREFILL, INFUSION] | [None]
GOLEMTHAUMIUM | thaumcraft | Thaumium Golems | 2 | [GOLEMIRON, THAUMIUM] | [None]
TINYHAT | thaumcraft | Tiny Hats | 1 | [None] | [None]
TINYFEZ | thaumcraft | Tiny Fezzes | 1 | [None] | [None]
CORELUMBER | thaumcraft | Golem Core: Chop | 2 | [COREHARVEST, ELEMENTALAXE] | [None]
TINYGLASSES | thaumcraft | Tiny Spectacles | 1 | [None] | [None]
TINYVISOR | thaumcraft | Golem Visor | 1 | [None] | [None]
UPGRADEAIR | thaumcraft | Golem Upgrade: Air | 1 | [GOLEMBELL] | [None]
COREFISHING | thaumcraft | Golem Core: Fishing | 2 | [COREHARVEST, INFUSION] | [None]
COREGATHER | thaumcraft | Golem Core: Gather | 1 | [GOLEMSTRAW] | [None]
COREHARVEST | thaumcraft | Golem Core: Harvest | 2 | [COREGATHER] | [None]
COREBUTCHER | thaumcraft | Golem Core: Butcher | 2 | [COREGUARD, COREHARVEST] | [None]
COREGUARD | thaumcraft | Golem Core: Guard | 2 | [COREGATHER] | [None]
ADVANCEDGOLEM | thaumcraft | Advanced Golems | 2 | [INFUSION, UPGRADEAIR, UPGRADEEARTH, UPGRADEFIRE, UPGRADEWATER, UPGRADEORDER, UPGRADEENTROPY] | [None]
TINYARMOR | thaumcraft | Golem Iron Plating | 1 | [None] | [None]
COREFILL | thaumcraft | Golem Core: Fill | 2 | [COREGATHER] | [None]
GOLEMFETTER | thaumcraft | Golem Fetter | 1 | [GOLEMSTONE] | [None]
GOLEMSTRAW | thaumcraft | Straw Golems | 2 | [HUNGRYCHEST] | [None]
COREALCHEMY | thaumcraft | Golem Core: Alchemy | 2 | [CORELIQUID, INFUSION] | [None]
GOLEMSTONE | thaumcraft | Stone Golems | 2 | [GOLEMCLAY] | [None]
GOLEMIRON | thaumcraft | Iron Golems | 2 | [GOLEMSTONE] | [None]
CORELIQUID | thaumcraft | Golem Core: Decanting | 2 | [COREFILL] | [None]
COREEMPTY | thaumcraft | Golem Core: Empty | 2 | [COREGATHER] | [None]
UPGRADEORDER | thaumcraft | Golem Upgrade: Order | 1 | [GOLEMBELL] | [None]

=======[thaumcraft]=======
ELDRITCHMAJOR | thaumcraft | Eldritch Revelation | 1 | [ELDRITCHMINOR, CRIMSON] | [None]
ADVALCHEMYFURNACE | thaumcraft | Advanced Alchemical Furnace  | 1 | [PRIMPEARL, DISTILESSENTIA, VISPOWER] | [None]
ARMORVOIDFORTRESS | thaumcraft | Void Thaumaturge Robes | 3 | [VOIDMETAL, ENCHFABRIC, ELDRITCHMAJOR] | [None]
ENTEROUTER | thaumcraft | The Outer Lands  | 1 | [OCULUS] | [None]
FOCUSPRIMAL | thaumcraft | Wand Focus: Primal | 2 | [ELDRITCHMINOR] | [None]
ELDRITCHMINOR | thaumcraft | Eldritch Epiphany | 3 | [RESEARCHER2] | [RESEARCHER1, INFUSION]
ESSENTIARESERVOIR | thaumcraft | Advanced Essentia Storage  | 2 | [VOIDMETAL, CENTRIFUGE, INFUSION] | [None]
SANITYCHECK | thaumcraft | Sanity Check | 1 | [ELDRITCHMINOR] | [None]
ROD_primal_staff | thaumcraft | Staff Core of the Primal | 3 | [FOCUSPRIMAL] | [ROD_silverwood_staff, ROD_bone_staff, ROD_greatwood_staff, ROD_blaze_staff, ROD_reed_staff, ROD_obsidian_staff, ROD_quartz_staff, ROD_ice_staff]
OCULUS | thaumcraft | Opening the Eye | 1 | [CRIMSON, ELDRITCHMAJOR] | [None]
OUTERREV | thaumcraft | Revelations in the Outer Lands  | 1 | [ENTEROUTER] | [None]
PRIMALCRUSHER | thaumcraft | Primal Crusher  | 2 | [PRIMPEARL] | [VOIDMETAL, ELEMENTALPICK, ELEMENTALSHOVEL]
PRIMPEARL | thaumcraft | Primordial Pearl  | 1 | [ELDRITCHMINOR] | [None]
PRIMNODE | thaumcraft | Primordial Node Manipulation  | 1 | [PRIMPEARL] | [None]
CAP_void | thaumcraft | Void metal Wand Caps | 3 | [CAP_thaumium, VOIDMETAL] | [None]
VOIDMETAL | thaumcraft | Void metal | 2 | [THAUMIUM, ELDRITCHMINOR] | [None]

=======[thaumicadditions]=======
VISCONDENSATOR | thaumicadditions | Making vis from air! | 1 | [ENCHANTEDWOOD] | [None]
ARCANESEAL | thaumicadditions | Arcane Seal | 2 | [None] | [None]
INFUSER | thaumicadditions | Infuser | 2 | [None] | [None]
ADAMINITESWORD | thaumicadditions | Adaminite Sword | 3 | [ADAMINITECRAFTING] | [None]
SAXUM | thaumicadditions | Aspect: Saxum | 1 | [None] | [None]
TAINTEDSEEDS | thaumicadditions | Tainted Crops | 1 | [None] | [None]
WANDFOCUSXP | thaumicadditions | Let me have all the levels! | 1 | [None] | [None]
SEALSYMBOLLER | thaumicadditions | Seal Symboller | 2 | [SEALSYMBOLING] | [None]
ROD_ADAMINITEWOOD_staff | thaumicadditions | Adaminite Staff | 2 | [None] | [ROD_ADAMINITEWOOD, SCEPTRE]
ARCANEDICE | thaumicadditions | Arcane random. | 1 | [None] | [MITHRILLIUMCRAFTING, PRIMPEARL]
SINGULARITY | thaumicadditions | Singularity | 2 | [SINGULARITYCORE] | [None]
INFUSERDARK | thaumicadditions | Dark Infuser | 2 | [INFUSER] | [None]
SEALSYMBOLING | thaumicadditions | Seal Symbol | 2 | [ARCANESEAL] | [None]
ADAMINITEARMOR | thaumicadditions | Adaminite Armoury | 2 | [ADAMINITECRAFTING] | [None]
VISTRANSPORTEVOLVED | thaumicadditions | Vis transport evolved! | 1 | [ENCHANTEDWOOD] | [None]
SINGULARITYCORE | thaumicadditions | Black Hole Core | 2 | [MITHRILLIUMCRAFTING] | [None]
ENCHANTEDWOOD | thaumicadditions | Enchanting wood! | 1 | [None] | [None]
ROD_ADAMINITEWOOD | thaumicadditions | Adaminite Rod | 2 | [ADAMINITECRAFTING] | [None]
ARCANETRANSPORTER | thaumicadditions | Thaumic transporter | 1 | [THAUMIUM] | [None]
CAP_ADAMINITE | thaumicadditions | Adaminite Cap | 2 | [ADAMINITECRAFTING] | [None]
WANDFOCUSPROJECTILE | thaumicadditions | Shooting with nothing! | 1 | [None] | [None]
ADAMINITECRAFTING | thaumicadditions | Adaminite Crafting | 3 | [THAUMIUM] | [None]
CAP_MITHRILLIUM | thaumicadditions | Mithrillium Cap | 2 | [MITHRILLIUMCRAFTING] | [None]
MITHRILLIUMCRAFTING | thaumicadditions | Mithrillium Crafting | 2 | [THAUMIUM] | [None]
INFUSION_ACTIVATOR | thaumicadditions | Infusion matrix activation | 1 | [INFUSION] | [None]
GRANUM | thaumicadditions | Aspect: Granum | 1 | [None] | [None]
TRANSMUTATIONSTONEARCANE | thaumicadditions | Magic Transmutation | 3 | [None] | [MITHRILLIUMCRAFTING]

=======[ttinkerer]=======
FOCUS_SHADOWBEAM | ttinkerer | Wand Focus: Shadowbeam | 3 | [ROD_ICHORCLOTH] | [RESEARCHDUPE, KNOWFRAG, RESEARCHER2, NODEJAR, RESEARCHER1, NODETAPPER2, DECONSTRUCTOR, NODETAPPER1, THAUMONOMICON, NODEPRESERVE, NODESTABILIZER, WANDPEDFOC, VAMPBAT, ROD_bone, FOCUSEXCAVATION, SCEPTRE, ROD_quartz_staff, VISCHARGERELAY, ROD_ice, NODESTABILIZERADV, ROD_reed, ROD_greatwood_staff, ROD_silverwood_staff, FOCUSFROST, VISAMULET, FOCALMANIPULATION, FOCUSFIRE, CAP_gold, ROD_silverwood, VISPOWER, FOCUSPOUCH, CAP_copper, ROD_reed_staff, FOCUSSHOCK, CAP_silver, ROD_quartz, FOCUSWARDING, ROD_obsidian, FOCUSPORTABLEHOLE, CAP_thaumium, ROD_greatwood, ROD_blaze, ROD_bone_staff, ROD_obsidian_staff, FOCUSTRADE, ROD_ice_staff, WANDPED, ROD_blaze_staff, ALUMENTUM, ENTROPICPROCESSING, TRANSIRON, THAUMATORIUM, ALCHEMICALMANUFACTURE, TUBES, TRANSTIN, SANESOAP, TALLOW, PURESILVER, PURETIN, TRANSCOPPER, ESSENTIACRYSTAL, ARCANESPA, CENTRIFUGE, TRANSSILVER, PUREIRON, ALCHEMICALDUPLICATION, JARVOID, NITOR, PUREGOLD, DISTILESSENTIA, TUBEFILTER, PURELEAD, TRANSLEAD, TRANSGOLD, PURECOPPER, JARLABEL, RUNICEMERGENCY, GOGGLES, ELEMENTALPICK, ELEMENTALAXE, INFERNALFURNACE, ELEMENTALSHOVEL, LEVITATOR, WARDEDARCANA, FLUXSCRUB, BOOTSTRAVELLER, RESTABLE, MIRRORESSENTIA, PRIMALARROW, ARCANEEAR, RUNICCHARGED, RUNICHEALING, HOVERHARNESS, MASKGRINNINGDEVIL, ELEMENTALHOE, MIRRORHAND, ARCTABLE, INFUSION, RUNICKINETIC, PAVEWARD, MASKANGRYGHOST, MASKSIPPINGFIEND, ARCANELAMP, BELLOWS, HELMGOGGLES, RUNICARMOR, RUNICAUGMENTATION, SINSTONE, ELEMENTALSWORD, PAVETRAVEL, ARCANEBORE, INFUSIONENCHANTMENT, GOLEMCLAY, UPGRADEWATER, GOLEMTALLOW, GOLEMWOOD, GOLEMFLESH, UPGRADEEARTH, UPGRADEFIRE, UPGRADEENTROPY, COREUSE, TRAVELTRUNK, GOLEMBELL, CORESORTING, GOLEMTHAUMIUM, CORELUMBER, UPGRADEAIR, COREFISHING, COREGATHER, COREHARVEST, COREBUTCHER, COREGUARD, ADVANCEDGOLEM, COREFILL, GOLEMFETTER, GOLEMSTRAW, COREALCHEMY, GOLEMSTONE, GOLEMIRON, CORELIQUID, COREEMPTY, UPGRADEORDER, TTENCH_VAMPIRISM, TTENCH_VALIANCE, TTENCH_SHOCKWAVE, TTENCH_FINAL, TTENCH_ASCENT_BOOST, TTENCH_DISPERSED, TTENCH_SLOW_FALL, TTENCH_FOCUSED, TTENCH_SHATTER, TTENCH_QUICK_DRAW, TTENCH_POUNCE, TTENCH_DESINTEGRATE, INFUSED_POTIONS, TTENCH_AUTO_SMELT, TTENCH_TUNNEL]
DIMENSION_SHARDS | ttinkerer | Dimensional Shards | 1 | [None] | [RESEARCHDUPE, KNOWFRAG, RESEARCHER2, NODEJAR, RESEARCHER1, NODETAPPER2, DECONSTRUCTOR, NODETAPPER1, THAUMONOMICON, NODEPRESERVE, NODESTABILIZER, WANDPEDFOC, VAMPBAT, ROD_bone, FOCUSEXCAVATION, SCEPTRE, ROD_quartz_staff, VISCHARGERELAY, ROD_ice, NODESTABILIZERADV, ROD_reed, ROD_greatwood_staff, ROD_silverwood_staff, FOCUSFROST, VISAMULET, FOCALMANIPULATION, FOCUSFIRE, CAP_gold, ROD_silverwood, VISPOWER, FOCUSPOUCH, CAP_copper, ROD_reed_staff, FOCUSSHOCK, CAP_silver, ROD_quartz, FOCUSWARDING, ROD_obsidian, FOCUSPORTABLEHOLE, CAP_thaumium, ROD_greatwood, ROD_blaze, ROD_bone_staff, ROD_obsidian_staff, FOCUSTRADE, ROD_ice_staff, WANDPED, ROD_blaze_staff, ALUMENTUM, ENTROPICPROCESSING, TRANSIRON, THAUMATORIUM, ALCHEMICALMANUFACTURE, TUBES, TRANSTIN, SANESOAP, TALLOW, PURESILVER, PURETIN, TRANSCOPPER, ESSENTIACRYSTAL, ARCANESPA, CENTRIFUGE, TRANSSILVER, PUREIRON, ALCHEMICALDUPLICATION, JARVOID, NITOR, PUREGOLD, DISTILESSENTIA, TUBEFILTER, PURELEAD, TRANSLEAD, TRANSGOLD, PURECOPPER, JARLABEL, RUNICEMERGENCY, GOGGLES, ELEMENTALPICK, ELEMENTALAXE, INFERNALFURNACE, ELEMENTALSHOVEL, LEVITATOR, WARDEDARCANA, FLUXSCRUB, BOOTSTRAVELLER, RESTABLE, MIRRORESSENTIA, PRIMALARROW, ARCANEEAR, RUNICCHARGED, RUNICHEALING, HOVERHARNESS, MASKGRINNINGDEVIL, ELEMENTALHOE, MIRRORHAND, ARCTABLE, INFUSION, RUNICKINETIC, PAVEWARD, MASKANGRYGHOST, MASKSIPPINGFIEND, ARCANELAMP, BELLOWS, HELMGOGGLES, RUNICARMOR, RUNICAUGMENTATION, SINSTONE, ELEMENTALSWORD, PAVETRAVEL, ARCANEBORE, INFUSIONENCHANTMENT, GOLEMCLAY, UPGRADEWATER, GOLEMTALLOW, GOLEMWOOD, GOLEMFLESH, UPGRADEEARTH, UPGRADEFIRE, UPGRADEENTROPY, COREUSE, TRAVELTRUNK, GOLEMBELL, CORESORTING, GOLEMTHAUMIUM, CORELUMBER, UPGRADEAIR, COREFISHING, COREGATHER, COREHARVEST, COREBUTCHER, COREGUARD, ADVANCEDGOLEM, COREFILL, GOLEMFETTER, GOLEMSTRAW, COREALCHEMY, GOLEMSTONE, GOLEMIRON, CORELIQUID, COREEMPTY, UPGRADEORDER, TTENCH_VALIANCE, TTENCH_SHOCKWAVE, TTENCH_ASCENT_BOOST, TTENCH_DISPERSED, TTENCH_SLOW_FALL, TTENCH_FOCUSED, TTENCH_SHATTER, FOCUS_DISLOCATION, FOCUS_FLIGHT, TTENCH_TUNNEL, FOCUS_HEAL, FOCUS_TELEKINESIS, TTENCH_VAMPIRISM, BLOOD_SWORD, TTENCH_FINAL, BRIGHT_NITOR, TTENCH_QUICK_DRAW, TTENCH_POUNCE, TTENCH_DESINTEGRATE, INFUSED_POTIONS, GAS_REMOVER, TTENCH_AUTO_SMELT, FOCUS_SMELT]
TTENCH_VALIANCE | ttinkerer | Enchantment: Valiance | 2 | [TTENCH_VAMPIRISM] | [None]
FIRE_TERRA | ttinkerer | Elemental Fire: Terra | 2 | [BRIGHT_NITOR] | [None]
TTENCH_SHOCKWAVE | ttinkerer | Enchantment: Shockwave | 2 | [TTENCH_SLOW_FALL] | [None]
ICHOR_TOOLS | ttinkerer | Ichorium Tools | 3 | [ICHORIUM] | [ROD_ICHORCLOTH, RESEARCHDUPE, KNOWFRAG, RESEARCHER2, NODEJAR, RESEARCHER1, NODETAPPER2, DECONSTRUCTOR, NODETAPPER1, THAUMONOMICON, NODEPRESERVE, NODESTABILIZER, WANDPEDFOC, VAMPBAT, ROD_bone, FOCUSEXCAVATION, SCEPTRE, ROD_quartz_staff, VISCHARGERELAY, ROD_ice, NODESTABILIZERADV, ROD_reed, ROD_greatwood_staff, ROD_silverwood_staff, FOCUSFROST, VISAMULET, FOCALMANIPULATION, FOCUSFIRE, CAP_gold, ROD_silverwood, VISPOWER, FOCUSPOUCH, CAP_copper, ROD_reed_staff, FOCUSSHOCK, CAP_silver, ROD_quartz, FOCUSWARDING, ROD_obsidian, FOCUSPORTABLEHOLE, CAP_thaumium, ROD_greatwood, ROD_blaze, ROD_bone_staff, ROD_obsidian_staff, FOCUSTRADE, ROD_ice_staff, WANDPED, ROD_blaze_staff, ALUMENTUM, ENTROPICPROCESSING, TRANSIRON, THAUMATORIUM, ALCHEMICALMANUFACTURE, TUBES, TRANSTIN, SANESOAP, TALLOW, PURESILVER, PURETIN, TRANSCOPPER, ESSENTIACRYSTAL, ARCANESPA, CENTRIFUGE, TRANSSILVER, PUREIRON, ALCHEMICALDUPLICATION, JARVOID, NITOR, PUREGOLD, DISTILESSENTIA, TUBEFILTER, PURELEAD, TRANSLEAD, TRANSGOLD, PURECOPPER, JARLABEL, RUNICEMERGENCY, GOGGLES, ELEMENTALPICK, ELEMENTALAXE, INFERNALFURNACE, ELEMENTALSHOVEL, LEVITATOR, WARDEDARCANA, FLUXSCRUB, BOOTSTRAVELLER, RESTABLE, MIRRORESSENTIA, PRIMALARROW, ARCANEEAR, RUNICCHARGED, RUNICHEALING, HOVERHARNESS, MASKGRINNINGDEVIL, ELEMENTALHOE, MIRRORHAND, ARCTABLE, INFUSION, RUNICKINETIC, PAVEWARD, MASKANGRYGHOST, MASKSIPPINGFIEND, ARCANELAMP, BELLOWS, HELMGOGGLES, RUNICARMOR, RUNICAUGMENTATION, SINSTONE, ELEMENTALSWORD, PAVETRAVEL, ARCANEBORE, INFUSIONENCHANTMENT, GOLEMCLAY, UPGRADEWATER, GOLEMTALLOW, GOLEMWOOD, GOLEMFLESH, UPGRADEEARTH, UPGRADEFIRE, UPGRADEENTROPY, COREUSE, TRAVELTRUNK, GOLEMBELL, CORESORTING, GOLEMTHAUMIUM, CORELUMBER, UPGRADEAIR, COREFISHING, COREGATHER, COREHARVEST, COREBUTCHER, COREGUARD, ADVANCEDGOLEM, COREFILL, GOLEMFETTER, GOLEMSTRAW, COREALCHEMY, GOLEMSTONE, GOLEMIRON, CORELIQUID, COREEMPTY, UPGRADEORDER, TTENCH_VALIANCE, TTENCH_SHOCKWAVE, TTENCH_ASCENT_BOOST, TTENCH_DISPERSED, GASEOUS_SHADOW, TTENCH_SLOW_FALL, TTENCH_FOCUSED, TTENCH_SHATTER, FOCUS_DISLOCATION, FOCUS_FLIGHT, TTENCH_TUNNEL, FOCUS_HEAL, FOCUS_TELEKINESIS, GASEOUS_LIGHT, TTENCH_VAMPIRISM, BLOOD_SWORD, TTENCH_FINAL, CLEANSING_TALISMAN, XP_TALISMAN, BRIGHT_NITOR, TTENCH_QUICK_DRAW, TTENCH_POUNCE, TTENCH_DESINTEGRATE, INFUSED_POTIONS, GAS_REMOVER, TTENCH_AUTO_SMELT, FOCUS_SMELT]
GASEOUS_SHADOW | ttinkerer | Gaseous Tenebrae | 2 | [GASEOUS_LIGHT] | [None]
FOCUS_DEFLECT | ttinkerer | Wand Focus: Distortion | 3 | [FOCUS_SMELT] | [INFUSION]
TTENCH_FOCUSED | ttinkerer | Enchantment: Focused Strikes | 2 | [TTENCH_VAMPIRISM] | [None]
PLATFORM | ttinkerer | Ethereal Platform | 3 | [CLEANSING_TALISMAN] | [None]
REPAIRER | ttinkerer | Thaumic Restorer | 3 | [FUNNEL] | [INFUSION, THAUMIUM, ENCHFABRIC]
INTERFACE | ttinkerer | Transvector Interface | 1 | [DARK_QUARTZ] | [None]
SUMMON | ttinkerer | Mob Summoning | 3 | [BLOOD_SWORD] | [INFUSION]
FOCUS_FLIGHT | ttinkerer | Wand Focus: Uprising | 2 | [FOCUS_SMELT] | [INFUSION]
ICHOR_PICK_GEM | ttinkerer | Awakened Ichorium Pickaxe | 3 | [ICHOR_TOOLS] | [RESEARCHDUPE, KNOWFRAG, RESEARCHER2, NODEJAR, RESEARCHER1, NODETAPPER2, DECONSTRUCTOR, NODETAPPER1, THAUMONOMICON, NODEPRESERVE, NODESTABILIZER, WANDPEDFOC, VAMPBAT, ROD_bone, FOCUSEXCAVATION, SCEPTRE, ROD_quartz_staff, VISCHARGERELAY, ROD_ice, NODESTABILIZERADV, ROD_reed, ROD_greatwood_staff, ROD_silverwood_staff, FOCUSFROST, VISAMULET, FOCALMANIPULATION, FOCUSFIRE, CAP_gold, ROD_silverwood, VISPOWER, FOCUSPOUCH, CAP_copper, ROD_reed_staff, FOCUSSHOCK, CAP_silver, ROD_quartz, FOCUSWARDING, ROD_obsidian, FOCUSPORTABLEHOLE, CAP_thaumium, ROD_greatwood, ROD_blaze, ROD_bone_staff, ROD_obsidian_staff, FOCUSTRADE, ROD_ice_staff, WANDPED, ROD_blaze_staff, ALUMENTUM, ENTROPICPROCESSING, TRANSIRON, THAUMATORIUM, ALCHEMICALMANUFACTURE, TUBES, TRANSTIN, SANESOAP, TALLOW, PURESILVER, PURETIN, TRANSCOPPER, ESSENTIACRYSTAL, ARCANESPA, CENTRIFUGE, TRANSSILVER, PUREIRON, ALCHEMICALDUPLICATION, JARVOID, NITOR, PUREGOLD, DISTILESSENTIA, TUBEFILTER, PURELEAD, TRANSLEAD, TRANSGOLD, PURECOPPER, JARLABEL, RUNICEMERGENCY, GOGGLES, ELEMENTALPICK, ELEMENTALAXE, INFERNALFURNACE, ELEMENTALSHOVEL, LEVITATOR, WARDEDARCANA, FLUXSCRUB, BOOTSTRAVELLER, RESTABLE, MIRRORESSENTIA, PRIMALARROW, ARCANEEAR, RUNICCHARGED, RUNICHEALING, HOVERHARNESS, MASKGRINNINGDEVIL, ELEMENTALHOE, MIRRORHAND, ARCTABLE, INFUSION, RUNICKINETIC, PAVEWARD, MASKANGRYGHOST, MASKSIPPINGFIEND, ARCANELAMP, BELLOWS, HELMGOGGLES, RUNICARMOR, RUNICAUGMENTATION, SINSTONE, ELEMENTALSWORD, PAVETRAVEL, ARCANEBORE, INFUSIONENCHANTMENT, GOLEMCLAY, UPGRADEWATER, GOLEMTALLOW, GOLEMWOOD, GOLEMFLESH, UPGRADEEARTH, UPGRADEFIRE, UPGRADEENTROPY, COREUSE, TRAVELTRUNK, GOLEMBELL, CORESORTING, GOLEMTHAUMIUM, CORELUMBER, UPGRADEAIR, COREFISHING, COREGATHER, COREHARVEST, COREBUTCHER, COREGUARD, ADVANCEDGOLEM, COREFILL, GOLEMFETTER, GOLEMSTRAW, COREALCHEMY, GOLEMSTONE, GOLEMIRON, CORELIQUID, COREEMPTY, UPGRADEORDER, TTENCH_VALIANCE, TTENCH_SHOCKWAVE, TTENCH_ASCENT_BOOST, TTENCH_DISPERSED, TTENCH_SLOW_FALL, TTENCH_FOCUSED, TTENCH_SHATTER, FOCUS_DISLOCATION, FOCUS_FLIGHT, TTENCH_TUNNEL, FOCUS_TELEKINESIS, TTENCH_VAMPIRISM, TTENCH_FINAL, TTENCH_QUICK_DRAW, TTENCH_POUNCE, TTENCH_DESINTEGRATE, INFUSED_POTIONS, TTENCH_AUTO_SMELT, FOCUS_SMELT]
ICHOR_AXE_GEM | ttinkerer | Awakened Ichorium Axe | 3 | [ICHOR_TOOLS] | [RESEARCHDUPE, KNOWFRAG, RESEARCHER2, NODEJAR, RESEARCHER1, NODETAPPER2, DECONSTRUCTOR, NODETAPPER1, THAUMONOMICON, NODEPRESERVE, NODESTABILIZER, WANDPEDFOC, VAMPBAT, ROD_bone, FOCUSEXCAVATION, SCEPTRE, ROD_quartz_staff, VISCHARGERELAY, ROD_ice, NODESTABILIZERADV, ROD_reed, ROD_greatwood_staff, ROD_silverwood_staff, FOCUSFROST, VISAMULET, FOCALMANIPULATION, FOCUSFIRE, CAP_gold, ROD_silverwood, VISPOWER, FOCUSPOUCH, CAP_copper, ROD_reed_staff, FOCUSSHOCK, CAP_silver, ROD_quartz, FOCUSWARDING, ROD_obsidian, FOCUSPORTABLEHOLE, CAP_thaumium, ROD_greatwood, ROD_blaze, ROD_bone_staff, ROD_obsidian_staff, FOCUSTRADE, ROD_ice_staff, WANDPED, ROD_blaze_staff, ALUMENTUM, ENTROPICPROCESSING, TRANSIRON, THAUMATORIUM, ALCHEMICALMANUFACTURE, TUBES, TRANSTIN, SANESOAP, TALLOW, PURESILVER, PURETIN, TRANSCOPPER, ESSENTIACRYSTAL, ARCANESPA, CENTRIFUGE, TRANSSILVER, PUREIRON, ALCHEMICALDUPLICATION, JARVOID, NITOR, PUREGOLD, DISTILESSENTIA, TUBEFILTER, PURELEAD, TRANSLEAD, TRANSGOLD, PURECOPPER, JARLABEL, RUNICEMERGENCY, GOGGLES, ELEMENTALPICK, ELEMENTALAXE, INFERNALFURNACE, ELEMENTALSHOVEL, LEVITATOR, WARDEDARCANA, FLUXSCRUB, BOOTSTRAVELLER, RESTABLE, MIRRORESSENTIA, PRIMALARROW, ARCANEEAR, RUNICCHARGED, RUNICHEALING, HOVERHARNESS, MASKGRINNINGDEVIL, ELEMENTALHOE, MIRRORHAND, ARCTABLE, INFUSION, RUNICKINETIC, PAVEWARD, MASKANGRYGHOST, MASKSIPPINGFIEND, ARCANELAMP, BELLOWS, HELMGOGGLES, RUNICARMOR, RUNICAUGMENTATION, SINSTONE, ELEMENTALSWORD, PAVETRAVEL, ARCANEBORE, INFUSIONENCHANTMENT, GOLEMCLAY, UPGRADEWATER, GOLEMTALLOW, GOLEMWOOD, GOLEMFLESH, UPGRADEEARTH, UPGRADEFIRE, UPGRADEENTROPY, COREUSE, TRAVELTRUNK, GOLEMBELL, CORESORTING, GOLEMTHAUMIUM, CORELUMBER, UPGRADEAIR, COREFISHING, COREGATHER, COREHARVEST, COREBUTCHER, COREGUARD, ADVANCEDGOLEM, COREFILL, GOLEMFETTER, GOLEMSTRAW, COREALCHEMY, GOLEMSTONE, GOLEMIRON, CORELIQUID, COREEMPTY, UPGRADEORDER, TTENCH_VALIANCE, TTENCH_SHOCKWAVE, TTENCH_ASCENT_BOOST, TTENCH_DISPERSED, GASEOUS_SHADOW, TTENCH_SLOW_FALL, TTENCH_FOCUSED, TTENCH_SHATTER, FOCUS_DISLOCATION, FOCUS_FLIGHT, TTENCH_TUNNEL, FOCUS_HEAL, FOCUS_TELEKINESIS, GASEOUS_LIGHT, TTENCH_VAMPIRISM, BLOOD_SWORD, TTENCH_FINAL, XP_TALISMAN, BRIGHT_NITOR, TTENCH_QUICK_DRAW, TTENCH_POUNCE, TTENCH_DESINTEGRATE, INFUSED_POTIONS, GAS_REMOVER, TTENCH_AUTO_SMELT, FOCUS_SMELT]
FOCUS_RECALL | ttinkerer | Wand Focus: Celestial Recall | 3 | [WARP_GATE] | [ROD_ICHORCLOTH, RESEARCHDUPE, KNOWFRAG, RESEARCHER2, NODEJAR, RESEARCHER1, NODETAPPER2, DECONSTRUCTOR, NODETAPPER1, THAUMONOMICON, NODEPRESERVE, NODESTABILIZER, WANDPEDFOC, VAMPBAT, ROD_bone, FOCUSEXCAVATION, SCEPTRE, ROD_quartz_staff, VISCHARGERELAY, ROD_ice, NODESTABILIZERADV, ROD_reed, ROD_greatwood_staff, ROD_silverwood_staff, FOCUSFROST, VISAMULET, FOCALMANIPULATION, FOCUSFIRE, CAP_gold, ROD_silverwood, VISPOWER, FOCUSPOUCH, CAP_copper, ROD_reed_staff, FOCUSSHOCK, CAP_silver, ROD_quartz, FOCUSWARDING, ROD_obsidian, FOCUSPORTABLEHOLE, CAP_thaumium, ROD_greatwood, ROD_blaze, ROD_bone_staff, ROD_obsidian_staff, FOCUSTRADE, ROD_ice_staff, WANDPED, ROD_blaze_staff, ALUMENTUM, ENTROPICPROCESSING, TRANSIRON, THAUMATORIUM, ALCHEMICALMANUFACTURE, TUBES, TRANSTIN, SANESOAP, TALLOW, PURESILVER, PURETIN, TRANSCOPPER, ESSENTIACRYSTAL, ARCANESPA, CENTRIFUGE, TRANSSILVER, PUREIRON, ALCHEMICALDUPLICATION, JARVOID, NITOR, PUREGOLD, DISTILESSENTIA, TUBEFILTER, PURELEAD, TRANSLEAD, TRANSGOLD, PURECOPPER, JARLABEL, RUNICEMERGENCY, GOGGLES, ELEMENTALPICK, ELEMENTALAXE, INFERNALFURNACE, ELEMENTALSHOVEL, LEVITATOR, WARDEDARCANA, FLUXSCRUB, BOOTSTRAVELLER, RESTABLE, MIRRORESSENTIA, PRIMALARROW, ARCANEEAR, RUNICCHARGED, RUNICHEALING, HOVERHARNESS, MASKGRINNINGDEVIL, ELEMENTALHOE, MIRRORHAND, ARCTABLE, INFUSION, RUNICKINETIC, PAVEWARD, MASKANGRYGHOST, MASKSIPPINGFIEND, ARCANELAMP, BELLOWS, HELMGOGGLES, RUNICARMOR, RUNICAUGMENTATION, SINSTONE, ELEMENTALSWORD, PAVETRAVEL, ARCANEBORE, INFUSIONENCHANTMENT, GOLEMCLAY, UPGRADEWATER, GOLEMTALLOW, GOLEMWOOD, GOLEMFLESH, UPGRADEEARTH, UPGRADEFIRE, UPGRADEENTROPY, COREUSE, TRAVELTRUNK, GOLEMBELL, CORESORTING, GOLEMTHAUMIUM, CORELUMBER, UPGRADEAIR, COREFISHING, COREGATHER, COREHARVEST, COREBUTCHER, COREGUARD, ADVANCEDGOLEM, COREFILL, GOLEMFETTER, GOLEMSTRAW, COREALCHEMY, GOLEMSTONE, GOLEMIRON, CORELIQUID, COREEMPTY, UPGRADEORDER, TTENCH_VALIANCE, TTENCH_SHOCKWAVE, TTENCH_ASCENT_BOOST, TTENCH_DISPERSED, GASEOUS_SHADOW, TTENCH_SLOW_FALL, TTENCH_FOCUSED, TTENCH_SHATTER, FOCUS_DISLOCATION, FOCUS_FLIGHT, TTENCH_TUNNEL, FOCUS_HEAL, FOCUS_TELEKINESIS, GASEOUS_LIGHT, TTENCH_VAMPIRISM, BLOOD_SWORD, TTENCH_FINAL, CLEANSING_TALISMAN, REVEALING_HELM, XP_TALISMAN, BRIGHT_NITOR, TTENCH_QUICK_DRAW, TTENCH_POUNCE, TTENCH_DESINTEGRATE, INFUSED_POTIONS, GAS_REMOVER, TTENCH_AUTO_SMELT, FOCUS_SMELT]
FOCUS_HEAL | ttinkerer | Wand Focus: Mending | 2 | [FOCUS_DEFLECT] | [INFUSION]
BLOCK_TALISMAN | ttinkerer | Black Hole Ring | 3 | [ICHOR_PICK_GEM, ICHOR_SHOVEL_GEM] | [RESEARCHDUPE, KNOWFRAG, RESEARCHER2, NODEJAR, RESEARCHER1, NODETAPPER2, DECONSTRUCTOR, NODETAPPER1, THAUMONOMICON, NODEPRESERVE, NODESTABILIZER, WANDPEDFOC, VAMPBAT, ROD_bone, FOCUSEXCAVATION, SCEPTRE, ROD_quartz_staff, VISCHARGERELAY, ROD_ice, NODESTABILIZERADV, ROD_reed, ROD_greatwood_staff, ROD_silverwood_staff, FOCUSFROST, VISAMULET, FOCALMANIPULATION, FOCUSFIRE, CAP_gold, ROD_silverwood, VISPOWER, FOCUSPOUCH, CAP_copper, ROD_reed_staff, FOCUSSHOCK, CAP_silver, ROD_quartz, FOCUSWARDING, ROD_obsidian, FOCUSPORTABLEHOLE, CAP_thaumium, ROD_greatwood, ROD_blaze, ROD_bone_staff, ROD_obsidian_staff, FOCUSTRADE, ROD_ice_staff, WANDPED, ROD_blaze_staff, ALUMENTUM, ENTROPICPROCESSING, TRANSIRON, THAUMATORIUM, ALCHEMICALMANUFACTURE, TUBES, TRANSTIN, SANESOAP, TALLOW, PURESILVER, PURETIN, TRANSCOPPER, ESSENTIACRYSTAL, ARCANESPA, CENTRIFUGE, TRANSSILVER, PUREIRON, ALCHEMICALDUPLICATION, JARVOID, NITOR, PUREGOLD, DISTILESSENTIA, TUBEFILTER, PURELEAD, TRANSLEAD, TRANSGOLD, PURECOPPER, JARLABEL, RUNICEMERGENCY, GOGGLES, ELEMENTALPICK, ELEMENTALAXE, INFERNALFURNACE, ELEMENTALSHOVEL, LEVITATOR, WARDEDARCANA, FLUXSCRUB, BOOTSTRAVELLER, RESTABLE, MIRRORESSENTIA, PRIMALARROW, ARCANEEAR, RUNICCHARGED, RUNICHEALING, HOVERHARNESS, MASKGRINNINGDEVIL, ELEMENTALHOE, MIRRORHAND, ARCTABLE, INFUSION, RUNICKINETIC, PAVEWARD, MASKANGRYGHOST, MASKSIPPINGFIEND, ARCANELAMP, BELLOWS, HELMGOGGLES, RUNICARMOR, RUNICAUGMENTATION, SINSTONE, ELEMENTALSWORD, PAVETRAVEL, ARCANEBORE, INFUSIONENCHANTMENT, GOLEMCLAY, UPGRADEWATER, GOLEMTALLOW, GOLEMWOOD, GOLEMFLESH, UPGRADEEARTH, UPGRADEFIRE, UPGRADEENTROPY, COREUSE, TRAVELTRUNK, GOLEMBELL, CORESORTING, GOLEMTHAUMIUM, CORELUMBER, UPGRADEAIR, COREFISHING, COREGATHER, COREHARVEST, COREBUTCHER, COREGUARD, ADVANCEDGOLEM, COREFILL, GOLEMFETTER, GOLEMSTRAW, COREALCHEMY, GOLEMSTONE, GOLEMIRON, CORELIQUID, COREEMPTY, UPGRADEORDER, TTENCH_VALIANCE, TTENCH_SHOCKWAVE, TTENCH_ASCENT_BOOST, TTENCH_DISPERSED, GASEOUS_SHADOW, TTENCH_SLOW_FALL, TTENCH_FOCUSED, TTENCH_SHATTER, FOCUS_DISLOCATION, FOCUS_FLIGHT, TTENCH_TUNNEL, FOCUS_HEAL, FOCUS_TELEKINESIS, GASEOUS_LIGHT, TTENCH_VAMPIRISM, BLOOD_SWORD, TTENCH_FINAL, CLEANSING_TALISMAN, XP_TALISMAN, BRIGHT_NITOR, TTENCH_QUICK_DRAW, TTENCH_POUNCE, TTENCH_DESINTEGRATE, INFUSED_POTIONS, GAS_REMOVER, TTENCH_AUTO_SMELT, FOCUS_SMELT]
MAGNETS | ttinkerer | Kinetic Attraction | 3 | [INTERFACE] | [FOCUS_TELEKINESIS]
FOCUS_TELEKINESIS | ttinkerer | Wand Focus: Telekinesis | 2 | [FOCUS_FLIGHT] | [INFUSION]
TTENCH_VAMPIRISM | ttinkerer | Enchantment: Vampirism | 2 | [ENCHANTER] | [None]
ICHORCLOTH_BOOTS_GEM | ttinkerer | Boots of the Horizontal Shield | 3 | [ICHORCLOTH_ARMOR] | [RESEARCHDUPE, KNOWFRAG, RESEARCHER2, NODEJAR, RESEARCHER1, NODETAPPER2, DECONSTRUCTOR, NODETAPPER1, THAUMONOMICON, NODEPRESERVE, NODESTABILIZER, WANDPEDFOC, VAMPBAT, ROD_bone, FOCUSEXCAVATION, SCEPTRE, ROD_quartz_staff, VISCHARGERELAY, ROD_ice, NODESTABILIZERADV, ROD_reed, ROD_greatwood_staff, ROD_silverwood_staff, FOCUSFROST, VISAMULET, FOCALMANIPULATION, FOCUSFIRE, CAP_gold, ROD_silverwood, VISPOWER, FOCUSPOUCH, CAP_copper, ROD_reed_staff, FOCUSSHOCK, CAP_silver, ROD_quartz, FOCUSWARDING, ROD_obsidian, FOCUSPORTABLEHOLE, CAP_thaumium, ROD_greatwood, ROD_blaze, ROD_bone_staff, ROD_obsidian_staff, FOCUSTRADE, ROD_ice_staff, WANDPED, ROD_blaze_staff, ALUMENTUM, ENTROPICPROCESSING, TRANSIRON, THAUMATORIUM, ALCHEMICALMANUFACTURE, TUBES, TRANSTIN, SANESOAP, TALLOW, PURESILVER, PURETIN, TRANSCOPPER, ESSENTIACRYSTAL, ARCANESPA, CENTRIFUGE, TRANSSILVER, PUREIRON, ALCHEMICALDUPLICATION, JARVOID, NITOR, PUREGOLD, DISTILESSENTIA, TUBEFILTER, PURELEAD, TRANSLEAD, TRANSGOLD, PURECOPPER, JARLABEL, RUNICEMERGENCY, GOGGLES, ELEMENTALPICK, ELEMENTALAXE, INFERNALFURNACE, ELEMENTALSHOVEL, LEVITATOR, WARDEDARCANA, FLUXSCRUB, BOOTSTRAVELLER, RESTABLE, MIRRORESSENTIA, PRIMALARROW, ARCANEEAR, RUNICCHARGED, RUNICHEALING, HOVERHARNESS, MASKGRINNINGDEVIL, ELEMENTALHOE, MIRRORHAND, ARCTABLE, INFUSION, RUNICKINETIC, PAVEWARD, MASKANGRYGHOST, MASKSIPPINGFIEND, ARCANELAMP, BELLOWS, HELMGOGGLES, RUNICARMOR, RUNICAUGMENTATION, SINSTONE, ELEMENTALSWORD, PAVETRAVEL, ARCANEBORE, INFUSIONENCHANTMENT, GOLEMCLAY, UPGRADEWATER, GOLEMTALLOW, GOLEMWOOD, GOLEMFLESH, UPGRADEEARTH, UPGRADEFIRE, UPGRADEENTROPY, COREUSE, TRAVELTRUNK, GOLEMBELL, CORESORTING, GOLEMTHAUMIUM, CORELUMBER, UPGRADEAIR, COREFISHING, COREGATHER, COREHARVEST, COREBUTCHER, COREGUARD, ADVANCEDGOLEM, COREFILL, GOLEMFETTER, GOLEMSTRAW, COREALCHEMY, GOLEMSTONE, GOLEMIRON, CORELIQUID, COREEMPTY, UPGRADEORDER, TTENCH_VALIANCE, TTENCH_SHOCKWAVE, GASEOUS_SHADOW, TTENCH_FOCUSED, FOCUS_FLIGHT, FOCUS_HEAL, FOCUS_TELEKINESIS, TTENCH_VAMPIRISM, CLEANSING_TALISMAN, XP_TALISMAN, TTENCH_QUICK_DRAW, TTENCH_POUNCE, TTENCH_DESINTEGRATE, TTENCH_ASCENT_BOOST, TTENCH_DISPERSED, TTENCH_SLOW_FALL, TTENCH_SHATTER, FOCUS_DISLOCATION, TTENCH_TUNNEL, GASEOUS_LIGHT, BLOOD_SWORD, TTENCH_FINAL, REVEALING_HELM, BRIGHT_NITOR, INFUSED_POTIONS, GAS_REMOVER, TTENCH_AUTO_SMELT, FOCUS_SMELT]
CLEANSING_TALISMAN | ttinkerer | Talisman of Remedium | 3 | [DARK_QUARTZ] | [INFUSION]
SPELL_CLOTH | ttinkerer | Spellbinding Cloth | 2 | [None] | [ENCHFABRIC]
WARP_GATE | ttinkerer | Celestial Gateway | 3 | [ICHORCLOTH_CHEST_GEM] | [ICHORCLOTH_BOOTS_GEM, RESEARCHDUPE, KNOWFRAG, RESEARCHER2, NODEJAR, RESEARCHER1, NODETAPPER2, DECONSTRUCTOR, NODETAPPER1, THAUMONOMICON, NODEPRESERVE, NODESTABILIZER, WANDPEDFOC, VAMPBAT, ROD_bone, FOCUSEXCAVATION, SCEPTRE, ROD_quartz_staff, VISCHARGERELAY, ROD_ice, NODESTABILIZERADV, ROD_reed, ROD_greatwood_staff, ROD_silverwood_staff, FOCUSFROST, VISAMULET, FOCALMANIPULATION, FOCUSFIRE, CAP_gold, ROD_silverwood, VISPOWER, FOCUSPOUCH, CAP_copper, ROD_reed_staff, FOCUSSHOCK, CAP_silver, ROD_quartz, FOCUSWARDING, ROD_obsidian, FOCUSPORTABLEHOLE, CAP_thaumium, ROD_greatwood, ROD_blaze, ROD_bone_staff, ROD_obsidian_staff, FOCUSTRADE, ROD_ice_staff, WANDPED, ROD_blaze_staff, ALUMENTUM, ENTROPICPROCESSING, TRANSIRON, THAUMATORIUM, ALCHEMICALMANUFACTURE, TUBES, TRANSTIN, SANESOAP, TALLOW, PURESILVER, PURETIN, TRANSCOPPER, ESSENTIACRYSTAL, ARCANESPA, CENTRIFUGE, TRANSSILVER, PUREIRON, ALCHEMICALDUPLICATION, JARVOID, NITOR, PUREGOLD, DISTILESSENTIA, TUBEFILTER, PURELEAD, TRANSLEAD, TRANSGOLD, PURECOPPER, JARLABEL, RUNICEMERGENCY, GOGGLES, ELEMENTALPICK, ELEMENTALAXE, INFERNALFURNACE, ELEMENTALSHOVEL, LEVITATOR, WARDEDARCANA, FLUXSCRUB, BOOTSTRAVELLER, RESTABLE, MIRRORESSENTIA, PRIMALARROW, ARCANEEAR, RUNICCHARGED, RUNICHEALING, HOVERHARNESS, MASKGRINNINGDEVIL, ELEMENTALHOE, MIRRORHAND, ARCTABLE, INFUSION, RUNICKINETIC, PAVEWARD, MASKANGRYGHOST, MASKSIPPINGFIEND, ARCANELAMP, BELLOWS, HELMGOGGLES, RUNICARMOR, RUNICAUGMENTATION, SINSTONE, ELEMENTALSWORD, PAVETRAVEL, ARCANEBORE, INFUSIONENCHANTMENT, GOLEMCLAY, UPGRADEWATER, GOLEMTALLOW, GOLEMWOOD, GOLEMFLESH, UPGRADEEARTH, UPGRADEFIRE, UPGRADEENTROPY, COREUSE, TRAVELTRUNK, GOLEMBELL, CORESORTING, GOLEMTHAUMIUM, CORELUMBER, UPGRADEAIR, COREFISHING, COREGATHER, COREHARVEST, COREBUTCHER, COREGUARD, ADVANCEDGOLEM, COREFILL, GOLEMFETTER, GOLEMSTRAW, COREALCHEMY, GOLEMSTONE, GOLEMIRON, CORELIQUID, COREEMPTY, UPGRADEORDER, TTENCH_VALIANCE, FIRE_TERRA, TTENCH_SHOCKWAVE, GASEOUS_SHADOW, FOCUS_DEFLECT, TTENCH_FOCUSED, PLATFORM, REPAIRER, INTERFACE, SUMMON, FOCUS_FLIGHT, FOCUS_HEAL, MAGNETS, FOCUS_TELEKINESIS, TTENCH_VAMPIRISM, CLEANSING_TALISMAN, SPELL_CLOTH, XP_TALISMAN, TTENCH_QUICK_DRAW, TTENCH_POUNCE, TTENCH_DESINTEGRATE, FIRE_AER, TTENCH_ASCENT_BOOST, TTENCH_DISPERSED, TTENCH_SLOW_FALL, TTENCH_SHATTER, LEVITATOR_LOCOMOTIVE, FOCUS_DISLOCATION, TTENCH_TUNNEL, FIRE_ORDO, GASEOUS_LIGHT, BLOOD_SWORD, FIRE_AQUA, TTENCH_FINAL, REVEALING_HELM, BRIGHT_NITOR, FUNNEL, INFUSED_POTIONS, GAS_REMOVER, TTENCH_AUTO_SMELT, FOCUS_SMELT, FOCUS_ENDER_CHEST]
XP_TALISMAN | ttinkerer | Talisman of Withhold | 2 | [JARBRAIN, SPELL_CLOTH] | [INFUSION]
TTENCH_QUICK_DRAW | ttinkerer | Enchantment: Quick Draw | 2 | [ENCHANTER] | [None]
TTENCH_POUNCE | ttinkerer | Enchantment: Pounce | 2 | [TTENCH_ASCENT_BOOST] | [None]
ICHORCLOTH_LEGS_GEM | ttinkerer | Leggings of the Burning Mantle | 3 | [ICHORCLOTH_ARMOR] | [RESEARCHDUPE, KNOWFRAG, RESEARCHER2, NODEJAR, RESEARCHER1, NODETAPPER2, DECONSTRUCTOR, NODETAPPER1, THAUMONOMICON, NODEPRESERVE, NODESTABILIZER, WANDPEDFOC, VAMPBAT, ROD_bone, FOCUSEXCAVATION, SCEPTRE, ROD_quartz_staff, VISCHARGERELAY, ROD_ice, NODESTABILIZERADV, ROD_reed, ROD_greatwood_staff, ROD_silverwood_staff, FOCUSFROST, VISAMULET, FOCALMANIPULATION, FOCUSFIRE, CAP_gold, ROD_silverwood, VISPOWER, FOCUSPOUCH, CAP_copper, ROD_reed_staff, FOCUSSHOCK, CAP_silver, ROD_quartz, FOCUSWARDING, ROD_obsidian, FOCUSPORTABLEHOLE, CAP_thaumium, ROD_greatwood, ROD_blaze, ROD_bone_staff, ROD_obsidian_staff, FOCUSTRADE, ROD_ice_staff, WANDPED, ROD_blaze_staff, ALUMENTUM, ENTROPICPROCESSING, TRANSIRON, THAUMATORIUM, ALCHEMICALMANUFACTURE, TUBES, TRANSTIN, SANESOAP, TALLOW, PURESILVER, PURETIN, TRANSCOPPER, ESSENTIACRYSTAL, ARCANESPA, CENTRIFUGE, TRANSSILVER, PUREIRON, ALCHEMICALDUPLICATION, JARVOID, NITOR, PUREGOLD, DISTILESSENTIA, TUBEFILTER, PURELEAD, TRANSLEAD, TRANSGOLD, PURECOPPER, JARLABEL, RUNICEMERGENCY, GOGGLES, ELEMENTALPICK, ELEMENTALAXE, INFERNALFURNACE, ELEMENTALSHOVEL, LEVITATOR, WARDEDARCANA, FLUXSCRUB, BOOTSTRAVELLER, RESTABLE, MIRRORESSENTIA, PRIMALARROW, ARCANEEAR, RUNICCHARGED, RUNICHEALING, HOVERHARNESS, MASKGRINNINGDEVIL, ELEMENTALHOE, MIRRORHAND, ARCTABLE, INFUSION, RUNICKINETIC, PAVEWARD, MASKANGRYGHOST, MASKSIPPINGFIEND, ARCANELAMP, BELLOWS, HELMGOGGLES, RUNICARMOR, RUNICAUGMENTATION, SINSTONE, ELEMENTALSWORD, PAVETRAVEL, ARCANEBORE, INFUSIONENCHANTMENT, GOLEMCLAY, UPGRADEWATER, GOLEMTALLOW, GOLEMWOOD, GOLEMFLESH, UPGRADEEARTH, UPGRADEFIRE, UPGRADEENTROPY, COREUSE, TRAVELTRUNK, GOLEMBELL, CORESORTING, GOLEMTHAUMIUM, CORELUMBER, UPGRADEAIR, COREFISHING, COREGATHER, COREHARVEST, COREBUTCHER, COREGUARD, ADVANCEDGOLEM, COREFILL, GOLEMFETTER, GOLEMSTRAW, COREALCHEMY, GOLEMSTONE, GOLEMIRON, CORELIQUID, COREEMPTY, UPGRADEORDER, FOCUS_TELEKINESIS, TTENCH_VAMPIRISM, TTENCH_VALIANCE, TTENCH_SHOCKWAVE, TTENCH_FINAL, TTENCH_ASCENT_BOOST, TTENCH_DISPERSED, TTENCH_SLOW_FALL, TTENCH_FOCUSED, TTENCH_SHATTER, TTENCH_QUICK_DRAW, TTENCH_POUNCE, FOCUS_DISLOCATION, TTENCH_DESINTEGRATE, INFUSED_POTIONS, FOCUS_FLIGHT, TTENCH_AUTO_SMELT, FOCUS_SMELT, TTENCH_TUNNEL]
DISLOCATOR | ttinkerer | Transvector Dislocator | 3 | [INTERFACE] | [MIRROR]
TTENCH_DESINTEGRATE | ttinkerer | Enchantment: Disintegrate | 2 | [ENCHANTER] | [None]
ICHOR_SWORD_GEM | ttinkerer | Awakened Ichorium Sword | 3 | [ICHOR_TOOLS] | [RESEARCHDUPE, KNOWFRAG, RESEARCHER2, NODEJAR, RESEARCHER1, NODETAPPER2, DECONSTRUCTOR, NODETAPPER1, THAUMONOMICON, NODEPRESERVE, NODESTABILIZER, WANDPEDFOC, VAMPBAT, ROD_bone, FOCUSEXCAVATION, SCEPTRE, ROD_quartz_staff, VISCHARGERELAY, ROD_ice, NODESTABILIZERADV, ROD_reed, ROD_greatwood_staff, ROD_silverwood_staff, FOCUSFROST, VISAMULET, FOCALMANIPULATION, FOCUSFIRE, CAP_gold, ROD_silverwood, VISPOWER, FOCUSPOUCH, CAP_copper, ROD_reed_staff, FOCUSSHOCK, CAP_silver, ROD_quartz, FOCUSWARDING, ROD_obsidian, FOCUSPORTABLEHOLE, CAP_thaumium, ROD_greatwood, ROD_blaze, ROD_bone_staff, ROD_obsidian_staff, FOCUSTRADE, ROD_ice_staff, WANDPED, ROD_blaze_staff, ALUMENTUM, ENTROPICPROCESSING, TRANSIRON, THAUMATORIUM, ALCHEMICALMANUFACTURE, TUBES, TRANSTIN, SANESOAP, TALLOW, PURESILVER, PURETIN, TRANSCOPPER, ESSENTIACRYSTAL, ARCANESPA, CENTRIFUGE, TRANSSILVER, PUREIRON, ALCHEMICALDUPLICATION, JARVOID, NITOR, PUREGOLD, DISTILESSENTIA, TUBEFILTER, PURELEAD, TRANSLEAD, TRANSGOLD, PURECOPPER, JARLABEL, RUNICEMERGENCY, GOGGLES, ELEMENTALPICK, ELEMENTALAXE, INFERNALFURNACE, ELEMENTALSHOVEL, LEVITATOR, WARDEDARCANA, FLUXSCRUB, BOOTSTRAVELLER, RESTABLE, MIRRORESSENTIA, PRIMALARROW, ARCANEEAR, RUNICCHARGED, RUNICHEALING, HOVERHARNESS, MASKGRINNINGDEVIL, ELEMENTALHOE, MIRRORHAND, ARCTABLE, INFUSION, RUNICKINETIC, PAVEWARD, MASKANGRYGHOST, MASKSIPPINGFIEND, ARCANELAMP, BELLOWS, HELMGOGGLES, RUNICARMOR, RUNICAUGMENTATION, SINSTONE, ELEMENTALSWORD, PAVETRAVEL, ARCANEBORE, INFUSIONENCHANTMENT, GOLEMCLAY, UPGRADEWATER, GOLEMTALLOW, GOLEMWOOD, GOLEMFLESH, UPGRADEEARTH, UPGRADEFIRE, UPGRADEENTROPY, COREUSE, TRAVELTRUNK, GOLEMBELL, CORESORTING, GOLEMTHAUMIUM, CORELUMBER, UPGRADEAIR, COREFISHING, COREGATHER, COREHARVEST, COREBUTCHER, COREGUARD, ADVANCEDGOLEM, COREFILL, GOLEMFETTER, GOLEMSTRAW, COREALCHEMY, GOLEMSTONE, GOLEMIRON, CORELIQUID, COREEMPTY, UPGRADEORDER, TTENCH_VALIANCE, TTENCH_SHOCKWAVE, TTENCH_ASCENT_BOOST, TTENCH_DISPERSED, TTENCH_SLOW_FALL, TTENCH_FOCUSED, TTENCH_SHATTER, FOCUS_DISLOCATION, FOCUS_FLIGHT, TTENCH_TUNNEL, FOCUS_TELEKINESIS, TTENCH_VAMPIRISM, TTENCH_FINAL, TTENCH_QUICK_DRAW, TTENCH_POUNCE, TTENCH_DESINTEGRATE, INFUSED_POTIONS, TTENCH_AUTO_SMELT, FOCUS_SMELT]
DARK_QUARTZ | ttinkerer | Smokey Quartz | 1 | [None] | [None]
FIRE_AER | ttinkerer | Elemental Fire: Aer | 2 | [BRIGHT_NITOR] | [None]
ICHOR_POUCH | ttinkerer | Bottomless Pouch | 3 | [ICHOR_CLOTH] | [RESEARCHDUPE, KNOWFRAG, RESEARCHER2, NODEJAR, RESEARCHER1, NODETAPPER2, DECONSTRUCTOR, NODETAPPER1, THAUMONOMICON, NODEPRESERVE, NODESTABILIZER, WANDPEDFOC, VAMPBAT, ROD_bone, FOCUSEXCAVATION, SCEPTRE, ROD_quartz_staff, VISCHARGERELAY, ROD_ice, NODESTABILIZERADV, ROD_reed, ROD_greatwood_staff, ROD_silverwood_staff, FOCUSFROST, VISAMULET, FOCALMANIPULATION, FOCUSFIRE, CAP_gold, ROD_silverwood, VISPOWER, FOCUSPOUCH, CAP_copper, ROD_reed_staff, FOCUSSHOCK, CAP_silver, ROD_quartz, FOCUSWARDING, ROD_obsidian, FOCUSPORTABLEHOLE, CAP_thaumium, ROD_greatwood, ROD_blaze, ROD_bone_staff, ROD_obsidian_staff, FOCUSTRADE, ROD_ice_staff, WANDPED, ROD_blaze_staff, ALUMENTUM, ENTROPICPROCESSING, TRANSIRON, THAUMATORIUM, ALCHEMICALMANUFACTURE, TUBES, TRANSTIN, SANESOAP, TALLOW, PURESILVER, PURETIN, TRANSCOPPER, ESSENTIACRYSTAL, ARCANESPA, CENTRIFUGE, TRANSSILVER, PUREIRON, ALCHEMICALDUPLICATION, JARVOID, NITOR, PUREGOLD, DISTILESSENTIA, TUBEFILTER, PURELEAD, TRANSLEAD, TRANSGOLD, PURECOPPER, JARLABEL, RUNICEMERGENCY, GOGGLES, ELEMENTALPICK, ELEMENTALAXE, INFERNALFURNACE, ELEMENTALSHOVEL, LEVITATOR, WARDEDARCANA, FLUXSCRUB, BOOTSTRAVELLER, RESTABLE, MIRRORESSENTIA, PRIMALARROW, ARCANEEAR, RUNICCHARGED, RUNICHEALING, HOVERHARNESS, MASKGRINNINGDEVIL, ELEMENTALHOE, MIRRORHAND, ARCTABLE, INFUSION, RUNICKINETIC, PAVEWARD, MASKANGRYGHOST, MASKSIPPINGFIEND, ARCANELAMP, BELLOWS, HELMGOGGLES, RUNICARMOR, RUNICAUGMENTATION, SINSTONE, ELEMENTALSWORD, PAVETRAVEL, ARCANEBORE, INFUSIONENCHANTMENT, GOLEMCLAY, UPGRADEWATER, GOLEMTALLOW, GOLEMWOOD, GOLEMFLESH, UPGRADEEARTH, UPGRADEFIRE, UPGRADEENTROPY, COREUSE, TRAVELTRUNK, GOLEMBELL, CORESORTING, GOLEMTHAUMIUM, CORELUMBER, UPGRADEAIR, COREFISHING, COREGATHER, COREHARVEST, COREBUTCHER, COREGUARD, ADVANCEDGOLEM, COREFILL, GOLEMFETTER, GOLEMSTRAW, COREALCHEMY, GOLEMSTONE, GOLEMIRON, CORELIQUID, COREEMPTY, UPGRADEORDER, TTENCH_VALIANCE, TTENCH_SHOCKWAVE, TTENCH_ASCENT_BOOST, TTENCH_DISPERSED, GASEOUS_SHADOW, TTENCH_SLOW_FALL, TTENCH_FOCUSED, TTENCH_SHATTER, FOCUS_DISLOCATION, FOCUS_FLIGHT, TTENCH_TUNNEL, FOCUS_HEAL, FOCUS_TELEKINESIS, GASEOUS_LIGHT, TTENCH_VAMPIRISM, BLOOD_SWORD, TTENCH_FINAL, XP_TALISMAN, BRIGHT_NITOR, TTENCH_QUICK_DRAW, TTENCH_POUNCE, TTENCH_DESINTEGRATE, INFUSED_POTIONS, GAS_REMOVER, TTENCH_AUTO_SMELT, FOCUS_SMELT]
ENCHANTER | ttinkerer | Osmotic Enchanter | 3 | [SPELL_CLOTH] | [INFUSION]
FIRE_PERDITIO | ttinkerer | Elemental Fire: Perditio | 3 | [BRIGHT_NITOR] | [None]
SHARE_TOME | ttinkerer | Tome of Knowledge Sharing | 1 | [None] | [None]
ICHORCLOTH_HELM_GEM | ttinkerer | Cowl of the Abyssal Depths | 3 | [ICHORCLOTH_ARMOR] | [RESEARCHDUPE, KNOWFRAG, RESEARCHER2, NODEJAR, RESEARCHER1, NODETAPPER2, DECONSTRUCTOR, NODETAPPER1, THAUMONOMICON, NODEPRESERVE, NODESTABILIZER, WANDPEDFOC, VAMPBAT, ROD_bone, FOCUSEXCAVATION, SCEPTRE, ROD_quartz_staff, VISCHARGERELAY, ROD_ice, NODESTABILIZERADV, ROD_reed, ROD_greatwood_staff, ROD_silverwood_staff, FOCUSFROST, VISAMULET, FOCALMANIPULATION, FOCUSFIRE, CAP_gold, ROD_silverwood, VISPOWER, FOCUSPOUCH, CAP_copper, ROD_reed_staff, FOCUSSHOCK, CAP_silver, ROD_quartz, FOCUSWARDING, ROD_obsidian, FOCUSPORTABLEHOLE, CAP_thaumium, ROD_greatwood, ROD_blaze, ROD_bone_staff, ROD_obsidian_staff, FOCUSTRADE, ROD_ice_staff, WANDPED, ROD_blaze_staff, ALUMENTUM, ENTROPICPROCESSING, TRANSIRON, THAUMATORIUM, ALCHEMICALMANUFACTURE, TUBES, TRANSTIN, SANESOAP, TALLOW, PURESILVER, PURETIN, TRANSCOPPER, ESSENTIACRYSTAL, ARCANESPA, CENTRIFUGE, TRANSSILVER, PUREIRON, ALCHEMICALDUPLICATION, JARVOID, NITOR, PUREGOLD, DISTILESSENTIA, TUBEFILTER, PURELEAD, TRANSLEAD, TRANSGOLD, PURECOPPER, JARLABEL, RUNICEMERGENCY, GOGGLES, ELEMENTALPICK, ELEMENTALAXE, INFERNALFURNACE, ELEMENTALSHOVEL, LEVITATOR, WARDEDARCANA, FLUXSCRUB, BOOTSTRAVELLER, RESTABLE, MIRRORESSENTIA, PRIMALARROW, ARCANEEAR, RUNICCHARGED, RUNICHEALING, HOVERHARNESS, MASKGRINNINGDEVIL, ELEMENTALHOE, MIRRORHAND, ARCTABLE, INFUSION, RUNICKINETIC, PAVEWARD, MASKANGRYGHOST, MASKSIPPINGFIEND, ARCANELAMP, BELLOWS, HELMGOGGLES, RUNICARMOR, RUNICAUGMENTATION, SINSTONE, ELEMENTALSWORD, PAVETRAVEL, ARCANEBORE, INFUSIONENCHANTMENT, GOLEMCLAY, UPGRADEWATER, GOLEMTALLOW, GOLEMWOOD, GOLEMFLESH, UPGRADEEARTH, UPGRADEFIRE, UPGRADEENTROPY, COREUSE, TRAVELTRUNK, GOLEMBELL, CORESORTING, GOLEMTHAUMIUM, CORELUMBER, UPGRADEAIR, COREFISHING, COREGATHER, COREHARVEST, COREBUTCHER, COREGUARD, ADVANCEDGOLEM, COREFILL, GOLEMFETTER, GOLEMSTRAW, COREALCHEMY, GOLEMSTONE, GOLEMIRON, CORELIQUID, COREEMPTY, UPGRADEORDER, TTENCH_VALIANCE, TTENCH_SHOCKWAVE, GASEOUS_SHADOW, TTENCH_FOCUSED, FOCUS_FLIGHT, FOCUS_HEAL, FOCUS_TELEKINESIS, TTENCH_VAMPIRISM, CLEANSING_TALISMAN, XP_TALISMAN, TTENCH_QUICK_DRAW, TTENCH_POUNCE, TTENCH_DESINTEGRATE, TTENCH_ASCENT_BOOST, TTENCH_DISPERSED, TTENCH_SLOW_FALL, TTENCH_SHATTER, FOCUS_DISLOCATION, TTENCH_TUNNEL, GASEOUS_LIGHT, BLOOD_SWORD, TTENCH_FINAL, REVEALING_HELM, BRIGHT_NITOR, INFUSED_POTIONS, GAS_REMOVER, TTENCH_AUTO_SMELT, FOCUS_SMELT]
TTENCH_ASCENT_BOOST | ttinkerer | Enchantment: Ascent Boost | 2 | [ENCHANTER] | [None]
CAP_ICHOR | ttinkerer | Ichorium Wand Caps | 3 | [ICHORIUM] | [RESEARCHDUPE, KNOWFRAG, RESEARCHER2, NODEJAR, RESEARCHER1, NODETAPPER2, DECONSTRUCTOR, NODETAPPER1, THAUMONOMICON, NODEPRESERVE, NODESTABILIZER, WANDPEDFOC, VAMPBAT, ROD_bone, FOCUSEXCAVATION, SCEPTRE, ROD_quartz_staff, VISCHARGERELAY, ROD_ice, NODESTABILIZERADV, ROD_reed, ROD_greatwood_staff, ROD_silverwood_staff, FOCUSFROST, VISAMULET, FOCALMANIPULATION, FOCUSFIRE, CAP_gold, ROD_silverwood, VISPOWER, FOCUSPOUCH, CAP_copper, ROD_reed_staff, FOCUSSHOCK, CAP_silver, ROD_quartz, FOCUSWARDING, ROD_obsidian, FOCUSPORTABLEHOLE, CAP_thaumium, ROD_greatwood, ROD_blaze, ROD_bone_staff, ROD_obsidian_staff, FOCUSTRADE, ROD_ice_staff, WANDPED, ROD_blaze_staff, ALUMENTUM, ENTROPICPROCESSING, TRANSIRON, THAUMATORIUM, ALCHEMICALMANUFACTURE, TUBES, TRANSTIN, SANESOAP, TALLOW, PURESILVER, PURETIN, TRANSCOPPER, ESSENTIACRYSTAL, ARCANESPA, CENTRIFUGE, TRANSSILVER, PUREIRON, ALCHEMICALDUPLICATION, JARVOID, NITOR, PUREGOLD, DISTILESSENTIA, TUBEFILTER, PURELEAD, TRANSLEAD, TRANSGOLD, PURECOPPER, JARLABEL, RUNICEMERGENCY, GOGGLES, ELEMENTALPICK, ELEMENTALAXE, INFERNALFURNACE, ELEMENTALSHOVEL, LEVITATOR, WARDEDARCANA, FLUXSCRUB, BOOTSTRAVELLER, RESTABLE, MIRRORESSENTIA, PRIMALARROW, ARCANEEAR, RUNICCHARGED, RUNICHEALING, HOVERHARNESS, MASKGRINNINGDEVIL, ELEMENTALHOE, MIRRORHAND, ARCTABLE, INFUSION, RUNICKINETIC, PAVEWARD, MASKANGRYGHOST, MASKSIPPINGFIEND, ARCANELAMP, BELLOWS, HELMGOGGLES, RUNICARMOR, RUNICAUGMENTATION, SINSTONE, ELEMENTALSWORD, PAVETRAVEL, ARCANEBORE, INFUSIONENCHANTMENT, GOLEMCLAY, UPGRADEWATER, GOLEMTALLOW, GOLEMWOOD, GOLEMFLESH, UPGRADEEARTH, UPGRADEFIRE, UPGRADEENTROPY, COREUSE, TRAVELTRUNK, GOLEMBELL, CORESORTING, GOLEMTHAUMIUM, CORELUMBER, UPGRADEAIR, COREFISHING, COREGATHER, COREHARVEST, COREBUTCHER, COREGUARD, ADVANCEDGOLEM, COREFILL, GOLEMFETTER, GOLEMSTRAW, COREALCHEMY, GOLEMSTONE, GOLEMIRON, CORELIQUID, COREEMPTY, UPGRADEORDER, TTENCH_VALIANCE, TTENCH_SHOCKWAVE, TTENCH_ASCENT_BOOST, TTENCH_DISPERSED, TTENCH_SLOW_FALL, TTENCH_FOCUSED, TTENCH_SHATTER, FOCUS_DISLOCATION, FOCUS_FLIGHT, TTENCH_TUNNEL, FOCUS_HEAL, FOCUS_TELEKINESIS, TTENCH_VAMPIRISM, BLOOD_SWORD, TTENCH_FINAL, BRIGHT_NITOR, TTENCH_QUICK_DRAW, TTENCH_POUNCE, TTENCH_DESINTEGRATE, INFUSED_POTIONS, GAS_REMOVER, TTENCH_AUTO_SMELT, FOCUS_SMELT]
TTENCH_DISPERSED | ttinkerer | Enchantment: Dispersed Strikes | 2 | [TTENCH_VAMPIRISM] | [None]
TTENCH_SLOW_FALL | ttinkerer | Enchantment: Slow Fall | 2 | [ENCHANTER] | [None]
TTENCH_SHATTER | ttinkerer | Enchantment: Shatter | 2 | [TTENCH_DESINTEGRATE] | [None]
LEVITATOR_LOCOMOTIVE | ttinkerer | Levitational Locomotive | 3 | [MAGNETS] | [INFUSION]
ICHORCLOTH_ARMOR | ttinkerer | Ichorcloth Robes | 3 | [ICHOR_CLOTH] | [RESEARCHDUPE, KNOWFRAG, RESEARCHER2, NODEJAR, RESEARCHER1, NODETAPPER2, DECONSTRUCTOR, NODETAPPER1, THAUMONOMICON, NODEPRESERVE, NODESTABILIZER, WANDPEDFOC, VAMPBAT, ROD_bone, FOCUSEXCAVATION, SCEPTRE, ROD_quartz_staff, VISCHARGERELAY, ROD_ice, NODESTABILIZERADV, ROD_reed, ROD_greatwood_staff, ROD_silverwood_staff, FOCUSFROST, VISAMULET, FOCALMANIPULATION, FOCUSFIRE, CAP_gold, ROD_silverwood, VISPOWER, FOCUSPOUCH, CAP_copper, ROD_reed_staff, FOCUSSHOCK, CAP_silver, ROD_quartz, FOCUSWARDING, ROD_obsidian, FOCUSPORTABLEHOLE, CAP_thaumium, ROD_greatwood, ROD_blaze, ROD_bone_staff, ROD_obsidian_staff, FOCUSTRADE, ROD_ice_staff, WANDPED, ROD_blaze_staff, ALUMENTUM, ENTROPICPROCESSING, TRANSIRON, THAUMATORIUM, ALCHEMICALMANUFACTURE, TUBES, TRANSTIN, SANESOAP, TALLOW, PURESILVER, PURETIN, TRANSCOPPER, ESSENTIACRYSTAL, ARCANESPA, CENTRIFUGE, TRANSSILVER, PUREIRON, ALCHEMICALDUPLICATION, JARVOID, NITOR, PUREGOLD, DISTILESSENTIA, TUBEFILTER, PURELEAD, TRANSLEAD, TRANSGOLD, PURECOPPER, JARLABEL, RUNICEMERGENCY, GOGGLES, ELEMENTALPICK, ELEMENTALAXE, INFERNALFURNACE, ELEMENTALSHOVEL, LEVITATOR, WARDEDARCANA, FLUXSCRUB, BOOTSTRAVELLER, RESTABLE, MIRRORESSENTIA, PRIMALARROW, ARCANEEAR, RUNICCHARGED, RUNICHEALING, HOVERHARNESS, MASKGRINNINGDEVIL, ELEMENTALHOE, MIRRORHAND, ARCTABLE, INFUSION, RUNICKINETIC, PAVEWARD, MASKANGRYGHOST, MASKSIPPINGFIEND, ARCANELAMP, BELLOWS, HELMGOGGLES, RUNICARMOR, RUNICAUGMENTATION, SINSTONE, ELEMENTALSWORD, PAVETRAVEL, ARCANEBORE, INFUSIONENCHANTMENT, GOLEMCLAY, UPGRADEWATER, GOLEMTALLOW, GOLEMWOOD, GOLEMFLESH, UPGRADEEARTH, UPGRADEFIRE, UPGRADEENTROPY, COREUSE, TRAVELTRUNK, GOLEMBELL, CORESORTING, GOLEMTHAUMIUM, CORELUMBER, UPGRADEAIR, COREFISHING, COREGATHER, COREHARVEST, COREBUTCHER, COREGUARD, ADVANCEDGOLEM, COREFILL, GOLEMFETTER, GOLEMSTRAW, COREALCHEMY, GOLEMSTONE, GOLEMIRON, CORELIQUID, COREEMPTY, UPGRADEORDER, TTENCH_VAMPIRISM, TTENCH_VALIANCE, TTENCH_SHOCKWAVE, TTENCH_FINAL, TTENCH_ASCENT_BOOST, TTENCH_DISPERSED, TTENCH_SLOW_FALL, TTENCH_FOCUSED, TTENCH_SHATTER, TTENCH_QUICK_DRAW, TTENCH_POUNCE, TTENCH_DESINTEGRATE, INFUSED_POTIONS, FOCUS_FLIGHT, TTENCH_AUTO_SMELT, FOCUS_SMELT, TTENCH_TUNNEL]
ICHOR_SHOVEL_GEM | ttinkerer | Awakened Ichorium Shovel | 3 | [ICHOR_TOOLS] | [RESEARCHDUPE, KNOWFRAG, RESEARCHER2, NODEJAR, RESEARCHER1, NODETAPPER2, DECONSTRUCTOR, NODETAPPER1, THAUMONOMICON, NODEPRESERVE, NODESTABILIZER, WANDPEDFOC, VAMPBAT, ROD_bone, FOCUSEXCAVATION, SCEPTRE, ROD_quartz_staff, VISCHARGERELAY, ROD_ice, NODESTABILIZERADV, ROD_reed, ROD_greatwood_staff, ROD_silverwood_staff, FOCUSFROST, VISAMULET, FOCALMANIPULATION, FOCUSFIRE, CAP_gold, ROD_silverwood, VISPOWER, FOCUSPOUCH, CAP_copper, ROD_reed_staff, FOCUSSHOCK, CAP_silver, ROD_quartz, FOCUSWARDING, ROD_obsidian, FOCUSPORTABLEHOLE, CAP_thaumium, ROD_greatwood, ROD_blaze, ROD_bone_staff, ROD_obsidian_staff, FOCUSTRADE, ROD_ice_staff, WANDPED, ROD_blaze_staff, ALUMENTUM, ENTROPICPROCESSING, TRANSIRON, THAUMATORIUM, ALCHEMICALMANUFACTURE, TUBES, TRANSTIN, SANESOAP, TALLOW, PURESILVER, PURETIN, TRANSCOPPER, ESSENTIACRYSTAL, ARCANESPA, CENTRIFUGE, TRANSSILVER, PUREIRON, ALCHEMICALDUPLICATION, JARVOID, NITOR, PUREGOLD, DISTILESSENTIA, TUBEFILTER, PURELEAD, TRANSLEAD, TRANSGOLD, PURECOPPER, JARLABEL, RUNICEMERGENCY, GOGGLES, ELEMENTALPICK, ELEMENTALAXE, INFERNALFURNACE, ELEMENTALSHOVEL, LEVITATOR, WARDEDARCANA, FLUXSCRUB, BOOTSTRAVELLER, RESTABLE, MIRRORESSENTIA, PRIMALARROW, ARCANEEAR, RUNICCHARGED, RUNICHEALING, HOVERHARNESS, MASKGRINNINGDEVIL, ELEMENTALHOE, MIRRORHAND, ARCTABLE, INFUSION, RUNICKINETIC, PAVEWARD, MASKANGRYGHOST, MASKSIPPINGFIEND, ARCANELAMP, BELLOWS, HELMGOGGLES, RUNICARMOR, RUNICAUGMENTATION, SINSTONE, ELEMENTALSWORD, PAVETRAVEL, ARCANEBORE, INFUSIONENCHANTMENT, GOLEMCLAY, UPGRADEWATER, GOLEMTALLOW, GOLEMWOOD, GOLEMFLESH, UPGRADEEARTH, UPGRADEFIRE, UPGRADEENTROPY, COREUSE, TRAVELTRUNK, GOLEMBELL, CORESORTING, GOLEMTHAUMIUM, CORELUMBER, UPGRADEAIR, COREFISHING, COREGATHER, COREHARVEST, COREBUTCHER, COREGUARD, ADVANCEDGOLEM, COREFILL, GOLEMFETTER, GOLEMSTRAW, COREALCHEMY, GOLEMSTONE, GOLEMIRON, CORELIQUID, COREEMPTY, UPGRADEORDER, TTENCH_VAMPIRISM, TTENCH_VALIANCE, TTENCH_SHOCKWAVE, TTENCH_FINAL, TTENCH_ASCENT_BOOST, TTENCH_DISPERSED, TTENCH_SLOW_FALL, TTENCH_FOCUSED, TTENCH_SHATTER, TTENCH_QUICK_DRAW, TTENCH_POUNCE, TTENCH_DESINTEGRATE, INFUSED_POTIONS, FOCUS_FLIGHT, TTENCH_AUTO_SMELT, TTENCH_TUNNEL]
ICHOR_CLOTH | ttinkerer | Ichorcloth | 3 | [ICHOR] | [RESEARCHDUPE, KNOWFRAG, RESEARCHER2, NODEJAR, RESEARCHER1, NODETAPPER2, DECONSTRUCTOR, NODETAPPER1, THAUMONOMICON, NODEPRESERVE, NODESTABILIZER, WANDPEDFOC, VAMPBAT, ROD_bone, FOCUSEXCAVATION, SCEPTRE, ROD_quartz_staff, VISCHARGERELAY, ROD_ice, NODESTABILIZERADV, ROD_reed, ROD_greatwood_staff, ROD_silverwood_staff, FOCUSFROST, VISAMULET, FOCALMANIPULATION, FOCUSFIRE, CAP_gold, ROD_silverwood, VISPOWER, FOCUSPOUCH, CAP_copper, ROD_reed_staff, FOCUSSHOCK, CAP_silver, ROD_quartz, FOCUSWARDING, ROD_obsidian, FOCUSPORTABLEHOLE, CAP_thaumium, ROD_greatwood, ROD_blaze, ROD_bone_staff, ROD_obsidian_staff, FOCUSTRADE, ROD_ice_staff, WANDPED, ROD_blaze_staff, ALUMENTUM, ENTROPICPROCESSING, TRANSIRON, THAUMATORIUM, ALCHEMICALMANUFACTURE, TUBES, TRANSTIN, SANESOAP, TALLOW, PURESILVER, PURETIN, TRANSCOPPER, ESSENTIACRYSTAL, ARCANESPA, CENTRIFUGE, TRANSSILVER, PUREIRON, ALCHEMICALDUPLICATION, JARVOID, NITOR, PUREGOLD, DISTILESSENTIA, TUBEFILTER, PURELEAD, TRANSLEAD, TRANSGOLD, PURECOPPER, JARLABEL, RUNICEMERGENCY, GOGGLES, ELEMENTALPICK, ELEMENTALAXE, INFERNALFURNACE, ELEMENTALSHOVEL, LEVITATOR, WARDEDARCANA, FLUXSCRUB, BOOTSTRAVELLER, RESTABLE, MIRRORESSENTIA, PRIMALARROW, ARCANEEAR, RUNICCHARGED, RUNICHEALING, HOVERHARNESS, MASKGRINNINGDEVIL, ELEMENTALHOE, MIRRORHAND, ARCTABLE, INFUSION, RUNICKINETIC, PAVEWARD, MASKANGRYGHOST, MASKSIPPINGFIEND, ARCANELAMP, BELLOWS, HELMGOGGLES, RUNICARMOR, RUNICAUGMENTATION, SINSTONE, ELEMENTALSWORD, PAVETRAVEL, ARCANEBORE, INFUSIONENCHANTMENT, GOLEMCLAY, UPGRADEWATER, GOLEMTALLOW, GOLEMWOOD, GOLEMFLESH, UPGRADEEARTH, UPGRADEFIRE, UPGRADEENTROPY, COREUSE, TRAVELTRUNK, GOLEMBELL, CORESORTING, GOLEMTHAUMIUM, CORELUMBER, UPGRADEAIR, COREFISHING, COREGATHER, COREHARVEST, COREBUTCHER, COREGUARD, ADVANCEDGOLEM, COREFILL, GOLEMFETTER, GOLEMSTRAW, COREALCHEMY, GOLEMSTONE, GOLEMIRON, CORELIQUID, COREEMPTY, UPGRADEORDER, TTENCH_VALIANCE, TTENCH_SHOCKWAVE, TTENCH_ASCENT_BOOST, TTENCH_DISPERSED, TTENCH_SLOW_FALL, TTENCH_FOCUSED, TTENCH_SHATTER, FOCUS_DISLOCATION, FOCUS_FLIGHT, TTENCH_TUNNEL, FOCUS_HEAL, FOCUS_TELEKINESIS, TTENCH_VAMPIRISM, BLOOD_SWORD, TTENCH_FINAL, BRIGHT_NITOR, TTENCH_QUICK_DRAW, TTENCH_POUNCE, TTENCH_DESINTEGRATE, INFUSED_POTIONS, GAS_REMOVER, TTENCH_AUTO_SMELT, FOCUS_SMELT]
FOCUS_DISLOCATION | ttinkerer | Wand Focus: Dislocation | 2 | [FOCUS_FLIGHT] | [INFUSION]
FIRE_IGNIS | ttinkerer | Elemental Fire: Ignis | 2 | [BRIGHT_NITOR] | [None]
TTENCH_TUNNEL | ttinkerer | Enchantment: Tunnel | 2 | [TTENCH_AUTO_SMELT] | [None]
FIRE_ORDO | ttinkerer | Elemental Fire: Ordo | 2 | [BRIGHT_NITOR] | [None]
CAT_AMULET | ttinkerer | Feline Amulet | 3 | [ICHORIUM] | [RESEARCHDUPE, KNOWFRAG, RESEARCHER2, NODEJAR, RESEARCHER1, NODETAPPER2, DECONSTRUCTOR, NODETAPPER1, THAUMONOMICON, NODEPRESERVE, NODESTABILIZER, WANDPEDFOC, VAMPBAT, ROD_bone, FOCUSEXCAVATION, SCEPTRE, ROD_quartz_staff, VISCHARGERELAY, ROD_ice, NODESTABILIZERADV, ROD_reed, ROD_greatwood_staff, ROD_silverwood_staff, FOCUSFROST, VISAMULET, FOCALMANIPULATION, FOCUSFIRE, CAP_gold, ROD_silverwood, VISPOWER, FOCUSPOUCH, CAP_copper, ROD_reed_staff, FOCUSSHOCK, CAP_silver, ROD_quartz, FOCUSWARDING, ROD_obsidian, FOCUSPORTABLEHOLE, CAP_thaumium, ROD_greatwood, ROD_blaze, ROD_bone_staff, ROD_obsidian_staff, FOCUSTRADE, ROD_ice_staff, WANDPED, ROD_blaze_staff, ALUMENTUM, ENTROPICPROCESSING, TRANSIRON, THAUMATORIUM, ALCHEMICALMANUFACTURE, TUBES, TRANSTIN, SANESOAP, TALLOW, PURESILVER, PURETIN, TRANSCOPPER, ESSENTIACRYSTAL, ARCANESPA, CENTRIFUGE, TRANSSILVER, PUREIRON, ALCHEMICALDUPLICATION, JARVOID, NITOR, PUREGOLD, DISTILESSENTIA, TUBEFILTER, PURELEAD, TRANSLEAD, TRANSGOLD, PURECOPPER, JARLABEL, RUNICEMERGENCY, GOGGLES, ELEMENTALPICK, ELEMENTALAXE, INFERNALFURNACE, ELEMENTALSHOVEL, LEVITATOR, WARDEDARCANA, FLUXSCRUB, BOOTSTRAVELLER, RESTABLE, MIRRORESSENTIA, PRIMALARROW, ARCANEEAR, RUNICCHARGED, RUNICHEALING, HOVERHARNESS, MASKGRINNINGDEVIL, ELEMENTALHOE, MIRRORHAND, ARCTABLE, INFUSION, RUNICKINETIC, PAVEWARD, MASKANGRYGHOST, MASKSIPPINGFIEND, ARCANELAMP, BELLOWS, HELMGOGGLES, RUNICARMOR, RUNICAUGMENTATION, SINSTONE, ELEMENTALSWORD, PAVETRAVEL, ARCANEBORE, INFUSIONENCHANTMENT, GOLEMCLAY, UPGRADEWATER, GOLEMTALLOW, GOLEMWOOD, GOLEMFLESH, UPGRADEEARTH, UPGRADEFIRE, UPGRADEENTROPY, COREUSE, TRAVELTRUNK, GOLEMBELL, CORESORTING, GOLEMTHAUMIUM, CORELUMBER, UPGRADEAIR, COREFISHING, COREGATHER, COREHARVEST, COREBUTCHER, COREGUARD, ADVANCEDGOLEM, COREFILL, GOLEMFETTER, GOLEMSTRAW, COREALCHEMY, GOLEMSTONE, GOLEMIRON, CORELIQUID, COREEMPTY, UPGRADEORDER, TTENCH_VAMPIRISM, TTENCH_VALIANCE, TTENCH_SHOCKWAVE, TTENCH_FINAL, TTENCH_ASCENT_BOOST, TTENCH_DISPERSED, TTENCH_SLOW_FALL, TTENCH_FOCUSED, TTENCH_SHATTER, TTENCH_QUICK_DRAW, TTENCH_POUNCE, TTENCH_DESINTEGRATE, INFUSED_POTIONS, FOCUS_FLIGHT, TTENCH_AUTO_SMELT, TTENCH_TUNNEL]
GASEOUS_LIGHT | ttinkerer | Gaseous Illuminae | 1 | [NITOR] | [None]
ICHORIUM | ttinkerer | Ichorium | 3 | [ICHOR] | [ICHOR_CLOTH, RESEARCHDUPE, KNOWFRAG, RESEARCHER2, NODEJAR, RESEARCHER1, NODETAPPER2, DECONSTRUCTOR, NODETAPPER1, THAUMONOMICON, NODEPRESERVE, NODESTABILIZER, WANDPEDFOC, VAMPBAT, ROD_bone, FOCUSEXCAVATION, SCEPTRE, ROD_quartz_staff, VISCHARGERELAY, ROD_ice, NODESTABILIZERADV, ROD_reed, ROD_greatwood_staff, ROD_silverwood_staff, FOCUSFROST, VISAMULET, FOCALMANIPULATION, FOCUSFIRE, CAP_gold, ROD_silverwood, VISPOWER, FOCUSPOUCH, CAP_copper, ROD_reed_staff, FOCUSSHOCK, CAP_silver, ROD_quartz, FOCUSWARDING, ROD_obsidian, FOCUSPORTABLEHOLE, CAP_thaumium, ROD_greatwood, ROD_blaze, ROD_bone_staff, ROD_obsidian_staff, FOCUSTRADE, ROD_ice_staff, WANDPED, ROD_blaze_staff, ALUMENTUM, ENTROPICPROCESSING, TRANSIRON, THAUMATORIUM, ALCHEMICALMANUFACTURE, TUBES, TRANSTIN, SANESOAP, TALLOW, PURESILVER, PURETIN, TRANSCOPPER, ESSENTIACRYSTAL, ARCANESPA, CENTRIFUGE, TRANSSILVER, PUREIRON, ALCHEMICALDUPLICATION, JARVOID, NITOR, PUREGOLD, DISTILESSENTIA, TUBEFILTER, PURELEAD, TRANSLEAD, TRANSGOLD, PURECOPPER, JARLABEL, RUNICEMERGENCY, GOGGLES, ELEMENTALPICK, ELEMENTALAXE, INFERNALFURNACE, ELEMENTALSHOVEL, LEVITATOR, WARDEDARCANA, FLUXSCRUB, BOOTSTRAVELLER, RESTABLE, MIRRORESSENTIA, PRIMALARROW, ARCANEEAR, RUNICCHARGED, RUNICHEALING, HOVERHARNESS, MASKGRINNINGDEVIL, ELEMENTALHOE, MIRRORHAND, ARCTABLE, INFUSION, RUNICKINETIC, PAVEWARD, MASKANGRYGHOST, MASKSIPPINGFIEND, ARCANELAMP, BELLOWS, HELMGOGGLES, RUNICARMOR, RUNICAUGMENTATION, SINSTONE, ELEMENTALSWORD, PAVETRAVEL, ARCANEBORE, INFUSIONENCHANTMENT, GOLEMCLAY, UPGRADEWATER, GOLEMTALLOW, GOLEMWOOD, GOLEMFLESH, UPGRADEEARTH, UPGRADEFIRE, UPGRADEENTROPY, COREUSE, TRAVELTRUNK, GOLEMBELL, CORESORTING, GOLEMTHAUMIUM, CORELUMBER, UPGRADEAIR, COREFISHING, COREGATHER, COREHARVEST, COREBUTCHER, COREGUARD, ADVANCEDGOLEM, COREFILL, GOLEMFETTER, GOLEMSTRAW, COREALCHEMY, GOLEMSTONE, GOLEMIRON, CORELIQUID, COREEMPTY, UPGRADEORDER, TTENCH_VALIANCE, TTENCH_SHOCKWAVE, TTENCH_ASCENT_BOOST, TTENCH_DISPERSED, TTENCH_SLOW_FALL, TTENCH_FOCUSED, TTENCH_SHATTER, FOCUS_DISLOCATION, FOCUS_FLIGHT, TTENCH_TUNNEL, FOCUS_HEAL, FOCUS_TELEKINESIS, TTENCH_VAMPIRISM, BLOOD_SWORD, TTENCH_FINAL, BRIGHT_NITOR, TTENCH_QUICK_DRAW, TTENCH_POUNCE, TTENCH_DESINTEGRATE, INFUSED_POTIONS, GAS_REMOVER, TTENCH_AUTO_SMELT, FOCUS_SMELT]
BLOOD_SWORD | ttinkerer | Cursed Spirit's Blade | 3 | [CLEANSING_TALISMAN] | [INFUSION]
ROD_ICHORCLOTH | ttinkerer | Ichorcloth Strapped Silverwood Wand Core | 3 | [ICHOR_CLOTH] | [CAP_ICHOR, RESEARCHDUPE, KNOWFRAG, RESEARCHER2, NODEJAR, RESEARCHER1, NODETAPPER2, DECONSTRUCTOR, NODETAPPER1, THAUMONOMICON, NODEPRESERVE, NODESTABILIZER, WANDPEDFOC, VAMPBAT, ROD_bone, FOCUSEXCAVATION, SCEPTRE, ROD_quartz_staff, VISCHARGERELAY, ROD_ice, NODESTABILIZERADV, ROD_reed, ROD_greatwood_staff, ROD_silverwood_staff, FOCUSFROST, VISAMULET, FOCALMANIPULATION, FOCUSFIRE, CAP_gold, ROD_silverwood, VISPOWER, FOCUSPOUCH, CAP_copper, ROD_reed_staff, FOCUSSHOCK, CAP_silver, ROD_quartz, FOCUSWARDING, ROD_obsidian, FOCUSPORTABLEHOLE, CAP_thaumium, ROD_greatwood, ROD_blaze, ROD_bone_staff, ROD_obsidian_staff, FOCUSTRADE, ROD_ice_staff, WANDPED, ROD_blaze_staff, ALUMENTUM, ENTROPICPROCESSING, TRANSIRON, THAUMATORIUM, ALCHEMICALMANUFACTURE, TUBES, TRANSTIN, SANESOAP, TALLOW, PURESILVER, PURETIN, TRANSCOPPER, ESSENTIACRYSTAL, ARCANESPA, CENTRIFUGE, TRANSSILVER, PUREIRON, ALCHEMICALDUPLICATION, JARVOID, NITOR, PUREGOLD, DISTILESSENTIA, TUBEFILTER, PURELEAD, TRANSLEAD, TRANSGOLD, PURECOPPER, JARLABEL, RUNICEMERGENCY, GOGGLES, ELEMENTALPICK, ELEMENTALAXE, INFERNALFURNACE, ELEMENTALSHOVEL, LEVITATOR, WARDEDARCANA, FLUXSCRUB, BOOTSTRAVELLER, RESTABLE, MIRRORESSENTIA, PRIMALARROW, ARCANEEAR, RUNICCHARGED, RUNICHEALING, HOVERHARNESS, MASKGRINNINGDEVIL, ELEMENTALHOE, MIRRORHAND, ARCTABLE, INFUSION, RUNICKINETIC, PAVEWARD, MASKANGRYGHOST, MASKSIPPINGFIEND, ARCANELAMP, BELLOWS, HELMGOGGLES, RUNICARMOR, RUNICAUGMENTATION, SINSTONE, ELEMENTALSWORD, PAVETRAVEL, ARCANEBORE, INFUSIONENCHANTMENT, GOLEMCLAY, UPGRADEWATER, GOLEMTALLOW, GOLEMWOOD, GOLEMFLESH, UPGRADEEARTH, UPGRADEFIRE, UPGRADEENTROPY, COREUSE, TRAVELTRUNK, GOLEMBELL, CORESORTING, GOLEMTHAUMIUM, CORELUMBER, UPGRADEAIR, COREFISHING, COREGATHER, COREHARVEST, COREBUTCHER, COREGUARD, ADVANCEDGOLEM, COREFILL, GOLEMFETTER, GOLEMSTRAW, COREALCHEMY, GOLEMSTONE, GOLEMIRON, CORELIQUID, COREEMPTY, UPGRADEORDER, TTENCH_VALIANCE, TTENCH_SHOCKWAVE, TTENCH_ASCENT_BOOST, TTENCH_DISPERSED, TTENCH_SLOW_FALL, TTENCH_FOCUSED, TTENCH_SHATTER, FOCUS_DISLOCATION, FOCUS_FLIGHT, TTENCH_TUNNEL, FOCUS_HEAL, FOCUS_TELEKINESIS, TTENCH_VAMPIRISM, BLOOD_SWORD, TTENCH_FINAL, BRIGHT_NITOR, TTENCH_QUICK_DRAW, TTENCH_POUNCE, TTENCH_DESINTEGRATE, INFUSED_POTIONS, GAS_REMOVER, TTENCH_AUTO_SMELT, FOCUS_SMELT]
FIRE_AQUA | ttinkerer | Elemental Fire: Aqua | 2 | [BRIGHT_NITOR] | [None]
TTENCH_FINAL | ttinkerer | Enchantment: Final Strike | 2 | [TTENCH_FOCUSED, TTENCH_DISPERSED] | [None]
FOCUS_XP_DRAIN | ttinkerer | Wand Focus: Experience Drain | 3 | [ROD_ICHORCLOTH] | [RESEARCHDUPE, KNOWFRAG, RESEARCHER2, NODEJAR, RESEARCHER1, NODETAPPER2, DECONSTRUCTOR, NODETAPPER1, THAUMONOMICON, NODEPRESERVE, NODESTABILIZER, WANDPEDFOC, VAMPBAT, ROD_bone, FOCUSEXCAVATION, SCEPTRE, ROD_quartz_staff, VISCHARGERELAY, ROD_ice, NODESTABILIZERADV, ROD_reed, ROD_greatwood_staff, ROD_silverwood_staff, FOCUSFROST, VISAMULET, FOCALMANIPULATION, FOCUSFIRE, CAP_gold, ROD_silverwood, VISPOWER, FOCUSPOUCH, CAP_copper, ROD_reed_staff, FOCUSSHOCK, CAP_silver, ROD_quartz, FOCUSWARDING, ROD_obsidian, FOCUSPORTABLEHOLE, CAP_thaumium, ROD_greatwood, ROD_blaze, ROD_bone_staff, ROD_obsidian_staff, FOCUSTRADE, ROD_ice_staff, WANDPED, ROD_blaze_staff, ALUMENTUM, ENTROPICPROCESSING, TRANSIRON, THAUMATORIUM, ALCHEMICALMANUFACTURE, TUBES, TRANSTIN, SANESOAP, TALLOW, PURESILVER, PURETIN, TRANSCOPPER, ESSENTIACRYSTAL, ARCANESPA, CENTRIFUGE, TRANSSILVER, PUREIRON, ALCHEMICALDUPLICATION, JARVOID, NITOR, PUREGOLD, DISTILESSENTIA, TUBEFILTER, PURELEAD, TRANSLEAD, TRANSGOLD, PURECOPPER, JARLABEL, RUNICEMERGENCY, GOGGLES, ELEMENTALPICK, ELEMENTALAXE, INFERNALFURNACE, ELEMENTALSHOVEL, LEVITATOR, WARDEDARCANA, FLUXSCRUB, BOOTSTRAVELLER, RESTABLE, MIRRORESSENTIA, PRIMALARROW, ARCANEEAR, RUNICCHARGED, RUNICHEALING, HOVERHARNESS, MASKGRINNINGDEVIL, ELEMENTALHOE, MIRRORHAND, ARCTABLE, INFUSION, RUNICKINETIC, PAVEWARD, MASKANGRYGHOST, MASKSIPPINGFIEND, ARCANELAMP, BELLOWS, HELMGOGGLES, RUNICARMOR, RUNICAUGMENTATION, SINSTONE, ELEMENTALSWORD, PAVETRAVEL, ARCANEBORE, INFUSIONENCHANTMENT, GOLEMCLAY, UPGRADEWATER, GOLEMTALLOW, GOLEMWOOD, GOLEMFLESH, UPGRADEEARTH, UPGRADEFIRE, UPGRADEENTROPY, COREUSE, TRAVELTRUNK, GOLEMBELL, CORESORTING, GOLEMTHAUMIUM, CORELUMBER, UPGRADEAIR, COREFISHING, COREGATHER, COREHARVEST, COREBUTCHER, COREGUARD, ADVANCEDGOLEM, COREFILL, GOLEMFETTER, GOLEMSTRAW, COREALCHEMY, GOLEMSTONE, GOLEMIRON, CORELIQUID, COREEMPTY, UPGRADEORDER, TTENCH_VALIANCE, TTENCH_SHOCKWAVE, GASEOUS_SHADOW, FOCUS_DEFLECT, TTENCH_FOCUSED, FOCUS_FLIGHT, FOCUS_HEAL, FOCUS_TELEKINESIS, TTENCH_VAMPIRISM, CLEANSING_TALISMAN, SPELL_CLOTH, XP_TALISMAN, TTENCH_QUICK_DRAW, TTENCH_POUNCE, TTENCH_DESINTEGRATE, TTENCH_ASCENT_BOOST, TTENCH_DISPERSED, TTENCH_SLOW_FALL, TTENCH_SHATTER, FOCUS_DISLOCATION, TTENCH_TUNNEL, GASEOUS_LIGHT, BLOOD_SWORD, TTENCH_FINAL, REVEALING_HELM, BRIGHT_NITOR, INFUSED_POTIONS, GAS_REMOVER, TTENCH_AUTO_SMELT, FOCUS_SMELT, FOCUS_ENDER_CHEST]
REVEALING_HELM | ttinkerer | Helmet of Revealing | 1 | [GOGGLES] | [THAUMIUM]
ICHORCLOTH_CHEST_GEM | ttinkerer | Robes of the Stratosphere | 3 | [ICHORCLOTH_ARMOR] | [RESEARCHDUPE, KNOWFRAG, RESEARCHER2, NODEJAR, RESEARCHER1, NODETAPPER2, DECONSTRUCTOR, NODETAPPER1, THAUMONOMICON, NODEPRESERVE, NODESTABILIZER, WANDPEDFOC, VAMPBAT, ROD_bone, FOCUSEXCAVATION, SCEPTRE, ROD_quartz_staff, VISCHARGERELAY, ROD_ice, NODESTABILIZERADV, ROD_reed, ROD_greatwood_staff, ROD_silverwood_staff, FOCUSFROST, VISAMULET, FOCALMANIPULATION, FOCUSFIRE, CAP_gold, ROD_silverwood, VISPOWER, FOCUSPOUCH, CAP_copper, ROD_reed_staff, FOCUSSHOCK, CAP_silver, ROD_quartz, FOCUSWARDING, ROD_obsidian, FOCUSPORTABLEHOLE, CAP_thaumium, ROD_greatwood, ROD_blaze, ROD_bone_staff, ROD_obsidian_staff, FOCUSTRADE, ROD_ice_staff, WANDPED, ROD_blaze_staff, ALUMENTUM, ENTROPICPROCESSING, TRANSIRON, THAUMATORIUM, ALCHEMICALMANUFACTURE, TUBES, TRANSTIN, SANESOAP, TALLOW, PURESILVER, PURETIN, TRANSCOPPER, ESSENTIACRYSTAL, ARCANESPA, CENTRIFUGE, TRANSSILVER, PUREIRON, ALCHEMICALDUPLICATION, JARVOID, NITOR, PUREGOLD, DISTILESSENTIA, TUBEFILTER, PURELEAD, TRANSLEAD, TRANSGOLD, PURECOPPER, JARLABEL, RUNICEMERGENCY, GOGGLES, ELEMENTALPICK, ELEMENTALAXE, INFERNALFURNACE, ELEMENTALSHOVEL, LEVITATOR, WARDEDARCANA, FLUXSCRUB, BOOTSTRAVELLER, RESTABLE, MIRRORESSENTIA, PRIMALARROW, ARCANEEAR, RUNICCHARGED, RUNICHEALING, HOVERHARNESS, MASKGRINNINGDEVIL, ELEMENTALHOE, MIRRORHAND, ARCTABLE, INFUSION, RUNICKINETIC, PAVEWARD, MASKANGRYGHOST, MASKSIPPINGFIEND, ARCANELAMP, BELLOWS, HELMGOGGLES, RUNICARMOR, RUNICAUGMENTATION, SINSTONE, ELEMENTALSWORD, PAVETRAVEL, ARCANEBORE, INFUSIONENCHANTMENT, GOLEMCLAY, UPGRADEWATER, GOLEMTALLOW, GOLEMWOOD, GOLEMFLESH, UPGRADEEARTH, UPGRADEFIRE, UPGRADEENTROPY, COREUSE, TRAVELTRUNK, GOLEMBELL, CORESORTING, GOLEMTHAUMIUM, CORELUMBER, UPGRADEAIR, COREFISHING, COREGATHER, COREHARVEST, COREBUTCHER, COREGUARD, ADVANCEDGOLEM, COREFILL, GOLEMFETTER, GOLEMSTRAW, COREALCHEMY, GOLEMSTONE, GOLEMIRON, CORELIQUID, COREEMPTY, UPGRADEORDER, TTENCH_VAMPIRISM, TTENCH_VALIANCE, TTENCH_SHOCKWAVE, TTENCH_FINAL, TTENCH_ASCENT_BOOST, TTENCH_DISPERSED, TTENCH_SLOW_FALL, TTENCH_FOCUSED, TTENCH_SHATTER, TTENCH_QUICK_DRAW, TTENCH_POUNCE, TTENCH_DESINTEGRATE, INFUSED_POTIONS, FOCUS_FLIGHT, TTENCH_AUTO_SMELT, TTENCH_TUNNEL]
BRIGHT_NITOR | ttinkerer | Hyperenergetic Nitor | 2 | [GASEOUS_LIGHT] | [None]
FUNNEL | ttinkerer | Essentia Funnel | 1 | [BRIGHT_NITOR] | [DISTILESSENTIA]
ICHOR | ttinkerer | Ichor | 3 | [None] | [RESEARCHDUPE, KNOWFRAG, RESEARCHER2, NODEJAR, RESEARCHER1, NODETAPPER2, DECONSTRUCTOR, NODETAPPER1, THAUMONOMICON, NODEPRESERVE, NODESTABILIZER, WANDPEDFOC, VAMPBAT, ROD_bone, FOCUSEXCAVATION, SCEPTRE, ROD_quartz_staff, VISCHARGERELAY, ROD_ice, NODESTABILIZERADV, ROD_reed, ROD_greatwood_staff, ROD_silverwood_staff, FOCUSFROST, VISAMULET, FOCALMANIPULATION, FOCUSFIRE, CAP_gold, ROD_silverwood, VISPOWER, FOCUSPOUCH, CAP_copper, ROD_reed_staff, FOCUSSHOCK, CAP_silver, ROD_quartz, FOCUSWARDING, ROD_obsidian, FOCUSPORTABLEHOLE, CAP_thaumium, ROD_greatwood, ROD_blaze, ROD_bone_staff, ROD_obsidian_staff, FOCUSTRADE, ROD_ice_staff, WANDPED, ROD_blaze_staff, ALUMENTUM, ENTROPICPROCESSING, TRANSIRON, THAUMATORIUM, ALCHEMICALMANUFACTURE, TUBES, TRANSTIN, SANESOAP, TALLOW, PURESILVER, PURETIN, TRANSCOPPER, ESSENTIACRYSTAL, ARCANESPA, CENTRIFUGE, TRANSSILVER, PUREIRON, ALCHEMICALDUPLICATION, JARVOID, NITOR, PUREGOLD, DISTILESSENTIA, TUBEFILTER, PURELEAD, TRANSLEAD, TRANSGOLD, PURECOPPER, JARLABEL, RUNICEMERGENCY, GOGGLES, ELEMENTALPICK, ELEMENTALAXE, INFERNALFURNACE, ELEMENTALSHOVEL, LEVITATOR, WARDEDARCANA, FLUXSCRUB, BOOTSTRAVELLER, RESTABLE, MIRRORESSENTIA, PRIMALARROW, ARCANEEAR, RUNICCHARGED, RUNICHEALING, HOVERHARNESS, MASKGRINNINGDEVIL, ELEMENTALHOE, MIRRORHAND, ARCTABLE, INFUSION, RUNICKINETIC, PAVEWARD, MASKANGRYGHOST, MASKSIPPINGFIEND, ARCANELAMP, BELLOWS, HELMGOGGLES, RUNICARMOR, RUNICAUGMENTATION, SINSTONE, ELEMENTALSWORD, PAVETRAVEL, ARCANEBORE, INFUSIONENCHANTMENT, GOLEMCLAY, UPGRADEWATER, GOLEMTALLOW, GOLEMWOOD, GOLEMFLESH, UPGRADEEARTH, UPGRADEFIRE, UPGRADEENTROPY, COREUSE, TRAVELTRUNK, GOLEMBELL, CORESORTING, GOLEMTHAUMIUM, CORELUMBER, UPGRADEAIR, COREFISHING, COREGATHER, COREHARVEST, COREBUTCHER, COREGUARD, ADVANCEDGOLEM, COREFILL, GOLEMFETTER, GOLEMSTRAW, COREALCHEMY, GOLEMSTONE, GOLEMIRON, CORELIQUID, COREEMPTY, UPGRADEORDER, TTENCH_VALIANCE, TTENCH_SHOCKWAVE, TTENCH_ASCENT_BOOST, TTENCH_DISPERSED, TTENCH_SLOW_FALL, TTENCH_FOCUSED, TTENCH_SHATTER, FOCUS_DISLOCATION, FOCUS_FLIGHT, TTENCH_TUNNEL, FOCUS_HEAL, FOCUS_TELEKINESIS, TTENCH_VAMPIRISM, BLOOD_SWORD, TTENCH_FINAL, BRIGHT_NITOR, TTENCH_QUICK_DRAW, TTENCH_POUNCE, TTENCH_DESINTEGRATE, INFUSED_POTIONS, GAS_REMOVER, TTENCH_AUTO_SMELT, FOCUS_SMELT]
PROTOCLAY | ttinkerer | Protoclay | 3 | [ICHOR_PICK_GEM] | [ICHOR_SHOVEL_GEM, RESEARCHDUPE, KNOWFRAG, RESEARCHER2, NODEJAR, RESEARCHER1, NODETAPPER2, DECONSTRUCTOR, NODETAPPER1, THAUMONOMICON, NODEPRESERVE, NODESTABILIZER, WANDPEDFOC, VAMPBAT, ROD_bone, FOCUSEXCAVATION, SCEPTRE, ROD_quartz_staff, VISCHARGERELAY, ROD_ice, NODESTABILIZERADV, ROD_reed, ROD_greatwood_staff, ROD_silverwood_staff, FOCUSFROST, VISAMULET, FOCALMANIPULATION, FOCUSFIRE, CAP_gold, ROD_silverwood, VISPOWER, FOCUSPOUCH, CAP_copper, ROD_reed_staff, FOCUSSHOCK, CAP_silver, ROD_quartz, FOCUSWARDING, ROD_obsidian, FOCUSPORTABLEHOLE, CAP_thaumium, ROD_greatwood, ROD_blaze, ROD_bone_staff, ROD_obsidian_staff, FOCUSTRADE, ROD_ice_staff, WANDPED, ROD_blaze_staff, ALUMENTUM, ENTROPICPROCESSING, TRANSIRON, THAUMATORIUM, ALCHEMICALMANUFACTURE, TUBES, TRANSTIN, SANESOAP, TALLOW, PURESILVER, PURETIN, TRANSCOPPER, ESSENTIACRYSTAL, ARCANESPA, CENTRIFUGE, TRANSSILVER, PUREIRON, ALCHEMICALDUPLICATION, JARVOID, NITOR, PUREGOLD, DISTILESSENTIA, TUBEFILTER, PURELEAD, TRANSLEAD, TRANSGOLD, PURECOPPER, JARLABEL, RUNICEMERGENCY, GOGGLES, ELEMENTALPICK, ELEMENTALAXE, INFERNALFURNACE, ELEMENTALSHOVEL, LEVITATOR, WARDEDARCANA, FLUXSCRUB, BOOTSTRAVELLER, RESTABLE, MIRRORESSENTIA, PRIMALARROW, ARCANEEAR, RUNICCHARGED, RUNICHEALING, HOVERHARNESS, MASKGRINNINGDEVIL, ELEMENTALHOE, MIRRORHAND, ARCTABLE, INFUSION, RUNICKINETIC, PAVEWARD, MASKANGRYGHOST, MASKSIPPINGFIEND, ARCANELAMP, BELLOWS, HELMGOGGLES, RUNICARMOR, RUNICAUGMENTATION, SINSTONE, ELEMENTALSWORD, PAVETRAVEL, ARCANEBORE, INFUSIONENCHANTMENT, GOLEMCLAY, UPGRADEWATER, GOLEMTALLOW, GOLEMWOOD, GOLEMFLESH, UPGRADEEARTH, UPGRADEFIRE, UPGRADEENTROPY, COREUSE, TRAVELTRUNK, GOLEMBELL, CORESORTING, GOLEMTHAUMIUM, CORELUMBER, UPGRADEAIR, COREFISHING, COREGATHER, COREHARVEST, COREBUTCHER, COREGUARD, ADVANCEDGOLEM, COREFILL, GOLEMFETTER, GOLEMSTRAW, COREALCHEMY, GOLEMSTONE, GOLEMIRON, CORELIQUID, COREEMPTY, UPGRADEORDER, TTENCH_VALIANCE, TTENCH_SHOCKWAVE, TTENCH_ASCENT_BOOST, TTENCH_DISPERSED, GASEOUS_SHADOW, TTENCH_SLOW_FALL, TTENCH_FOCUSED, TTENCH_SHATTER, FOCUS_DISLOCATION, FOCUS_FLIGHT, TTENCH_TUNNEL, FOCUS_HEAL, FOCUS_TELEKINESIS, GASEOUS_LIGHT, TTENCH_VAMPIRISM, BLOOD_SWORD, TTENCH_FINAL, BRIGHT_NITOR, TTENCH_QUICK_DRAW, TTENCH_POUNCE, TTENCH_DESINTEGRATE, INFUSED_POTIONS, GAS_REMOVER, TTENCH_AUTO_SMELT, FOCUS_SMELT]
ANIMATION_TABLET | ttinkerer | Dynamism Tablet | 3 | [MAGNETS] | [None]
INFUSED_POTIONS | ttinkerer | Infused Crops | 2 | [FIRE_PERDITIO, FIRE_ORDO, FIRE_IGNIS, FIRE_TERRA, FIRE_AER, FIRE_AQUA] | [INFUSION, INFUSION]
GAS_REMOVER | ttinkerer | Fume Dissipator | 1 | [GASEOUS_SHADOW] | [None]
TTENCH_AUTO_SMELT | ttinkerer | Enchantment: Flaming Touch | 2 | [ENCHANTER] | [None]
FOCUS_SMELT | ttinkerer | Wand Focus: Efreet's Flame | 2 | [FOCUSEXCAVATION] | [None]
FOCUS_ENDER_CHEST | ttinkerer | Wand Focus: Ender Rift | 2 | [FOCUS_DEFLECT] | [None]
PLACEMENT_MIRROR | ttinkerer | Worldshaper's Looking Glass | 3 | [BLOCK_TALISMAN] | [RESEARCHDUPE, KNOWFRAG, RESEARCHER2, NODEJAR, RESEARCHER1, NODETAPPER2, DECONSTRUCTOR, NODETAPPER1, THAUMONOMICON, NODEPRESERVE, NODESTABILIZER, WANDPEDFOC, VAMPBAT, ROD_bone, FOCUSEXCAVATION, SCEPTRE, ROD_quartz_staff, VISCHARGERELAY, ROD_ice, NODESTABILIZERADV, ROD_reed, ROD_greatwood_staff, ROD_silverwood_staff, FOCUSFROST, VISAMULET, FOCALMANIPULATION, FOCUSFIRE, CAP_gold, ROD_silverwood, VISPOWER, FOCUSPOUCH, CAP_copper, ROD_reed_staff, FOCUSSHOCK, CAP_silver, ROD_quartz, FOCUSWARDING, ROD_obsidian, FOCUSPORTABLEHOLE, CAP_thaumium, ROD_greatwood, ROD_blaze, ROD_bone_staff, ROD_obsidian_staff, FOCUSTRADE, ROD_ice_staff, WANDPED, ROD_blaze_staff, ALUMENTUM, ENTROPICPROCESSING, TRANSIRON, THAUMATORIUM, ALCHEMICALMANUFACTURE, TUBES, TRANSTIN, SANESOAP, TALLOW, PURESILVER, PURETIN, TRANSCOPPER, ESSENTIACRYSTAL, ARCANESPA, CENTRIFUGE, TRANSSILVER, PUREIRON, ALCHEMICALDUPLICATION, JARVOID, NITOR, PUREGOLD, DISTILESSENTIA, TUBEFILTER, PURELEAD, TRANSLEAD, TRANSGOLD, PURECOPPER, JARLABEL, RUNICEMERGENCY, GOGGLES, ELEMENTALPICK, ELEMENTALAXE, INFERNALFURNACE, ELEMENTALSHOVEL, LEVITATOR, WARDEDARCANA, FLUXSCRUB, BOOTSTRAVELLER, RESTABLE, MIRRORESSENTIA, PRIMALARROW, ARCANEEAR, RUNICCHARGED, RUNICHEALING, HOVERHARNESS, MASKGRINNINGDEVIL, ELEMENTALHOE, MIRRORHAND, ARCTABLE, INFUSION, RUNICKINETIC, PAVEWARD, MASKANGRYGHOST, MASKSIPPINGFIEND, ARCANELAMP, BELLOWS, HELMGOGGLES, RUNICARMOR, RUNICAUGMENTATION, SINSTONE, ELEMENTALSWORD, PAVETRAVEL, ARCANEBORE, INFUSIONENCHANTMENT, GOLEMCLAY, UPGRADEWATER, GOLEMTALLOW, GOLEMWOOD, GOLEMFLESH, UPGRADEEARTH, UPGRADEFIRE, UPGRADEENTROPY, COREUSE, TRAVELTRUNK, GOLEMBELL, CORESORTING, GOLEMTHAUMIUM, CORELUMBER, UPGRADEAIR, COREFISHING, COREGATHER, COREHARVEST, COREBUTCHER, COREGUARD, ADVANCEDGOLEM, COREFILL, GOLEMFETTER, GOLEMSTRAW, COREALCHEMY, GOLEMSTONE, GOLEMIRON, CORELIQUID, COREEMPTY, UPGRADEORDER, TTENCH_VALIANCE, TTENCH_SHOCKWAVE, GASEOUS_SHADOW, TTENCH_FOCUSED, FOCUS_FLIGHT, FOCUS_HEAL, FOCUS_TELEKINESIS, TTENCH_VAMPIRISM, CLEANSING_TALISMAN, XP_TALISMAN, TTENCH_QUICK_DRAW, TTENCH_POUNCE, TTENCH_DESINTEGRATE, TTENCH_ASCENT_BOOST, TTENCH_DISPERSED, TTENCH_SLOW_FALL, TTENCH_SHATTER, FOCUS_DISLOCATION, TTENCH_TUNNEL, GASEOUS_LIGHT, BLOOD_SWORD, TTENCH_FINAL, REVEALING_HELM, BRIGHT_NITOR, INFUSED_POTIONS, GAS_REMOVER, TTENCH_AUTO_SMELT, FOCUS_SMELT]

=======[forbidden]=======
ARCANECAKE | forbidden | Thaumic Cake | 2 | [NETHERSHARDS, INFUSION] | [None]
CAP_manasteel | forbidden | Manasteel Caps | 2 | [ROD_livingwood] | [None]
ROD_livingwood | forbidden | Livingwood Wand Core | 3 | [BOTANY, ROD_silverwood, INFUSION] | [None]
WHISPERWEED | forbidden | Whisperweed | 1 | [BOTANY] | [None]
TRANSEMERALD | forbidden | Emerald Transmutation | 3 | [TRANSGOLD] | [None]
HELLFIRE | forbidden | Lord of Hellfire | 1 | [NETHERSHARDS] | [None]
VOIDTOUCHED | forbidden | Enchantment: Voidtouched | 3 | [MORPHTOOLS, VOIDMETAL] | [None]
ROD_tainted | forbidden | Tainted Wand Core | 3 | [ROD_silverwood, TAINTSHOVEL, INFUSION] | [None]
BLOODWELL | forbidden | Bloody Scrivener's Tools | 1 | [BLOODMAGIC] | [None]
CONSUMING | forbidden | Enchantment: Consuming | 1 | [INFUSIONENCHANTMENT] | [None]
CLUSTER | forbidden | Enchantment: Fiery Core | 3 | [MORPHTOOLS, ELEMENTALPICK] | [None]
SUBCOLLAR | forbidden | Collar of Pain | 2 | [NETHERSHARDS, VISAMULET, INFUSION] | [None]
CRYSTALWELL | forbidden | Crystal Scribing Tools | 1 | [RESEARCH] | [None]
ROD_blood_staff | forbidden | Blood Staff Core | 2 | [ROD_silverwood_staff, ROD_blood] | [None]
TAINTSTONE | forbidden | Tainted Stone | 2 | [THAUMIUM, INFUSION, ETHEREALBLOOM] | [None]
ROD_blood | forbidden | Blood Wand Core | 3 | [ROD_silverwood, INFUSION, BLOODMAGIC] | [None]
PRIMEWELL | forbidden | Primal Scribing Tools | 1 | [PRIMPEARL] | [None]
ROD_blood_wood_staff | forbidden | Blood Infused Wood Staff Core | 3 | [ROD_blood_wood, ROD_blood_staff] | [None]
CAP_blood_iron | forbidden | Blood Infused Iron Caps | 2 | [ROD_blood_wood, CAP_alchemical] | [None]
IMPACT | forbidden | Enchantment: Impact | 3 | [MORPHTOOLS, ELEMENTALSHOVEL] | [None]
WRATHCAGE | forbidden | Wrath Cage | 3 | [FORK] | [INFUSION, THAUMIUM, DISTILESSENTIA]
BLACKFLOWER | forbidden | Umbral Rose | 1 | [None] | [None]
EUCLIDAISY | forbidden | Euclidaisy | 2 | [BOTANY, INFUSION] | [None]
MORPHTOOLS | forbidden | Chameleon Tools | 3 | [NETHERSHARDS] | [THAUMIUM, INFUSIONENCHANTMENT]
CAP_terrasteel | forbidden | Terrasteel Caps | 1 | [CAP_manasteel] | [None]
TAINTHISTLE | forbidden | Tainthistle | 2 | [BOTANY, INFUSION] | [None]
SKULLAXE | forbidden | Axe of the Skulltaker | 2 | [NETHERSHARDS, THAUMIUM, INFUSION] | [None]
BLOODRAPIER | forbidden | Rapier of the Strix | 3 | [BLOODMAGIC, INFUSION, VOIDMETAL] | [None]
ROD_dreamwood_staff | forbidden | Dreamwood Staff | 2 | [ROD_livingwood, ROD_silverwood_staff] | [None]
TAINTPICK | forbidden | Pickaxe of Distortion | 2 | [TAINTSHOVEL] | [None]
ROD_witchMoon | forbidden | Moonlight Blessed Witchwood Wand Core | 3 | [ROD_witchwood] | [None]
ROD_dreamwood | forbidden | forbidden.research_name.ROD_dreamwood | 0 | [None] | [None]
TAINTTREE | forbidden | Tainted Tree | 3 | [THAUMIUM, INFUSION, ETHEREALBLOOM] | [None]
WRATH | forbidden | Enchantment: Wrath | 3 | [NETHERSHARDS, INFUSIONENCHANTMENT] | [None]
SCHOOLS | forbidden | Schools of Magic | 1 | [None] | [None]
CAP_vinteum | forbidden | Vinteum Caps | 1 | [ROD_witchwood, CAP_thaumium] | [None]
ELDRITCHORB | forbidden | Eldritch Blood Orb | 3 | [BLOODMAGIC, INFUSION, PRIMPEARL, VOIDMETAL] | [None]
BLOODMAGIC | forbidden | Blood Magic | 1 | [SCHOOLS] | [None]
ROD_infernal | forbidden | Infernal Wand Core | 3 | [ROD_silverwood, INFUSION, NETHERSHARDS] | [None]
FORK | forbidden | Diabolist Fork | 1 | [INFUSION, NETHERSHARDS, THAUMIUM] | [None]
RINGFOOD | forbidden | Ring of Nutrition | 2 | [NETHERSHARDS] | [None]
CORRUPTING | forbidden | Enchantment: Corrupting | 1 | [NETHERSHARDS, INFUSIONENCHANTMENT] | [None]
BOTANY | forbidden | Botany | 1 | [SCHOOLS] | [None]
CAP_alchemical | forbidden | Alchemical Caps | 2 | [ROD_blood, CAP_gold] | [None]
RIDINGCROP | forbidden | Riding Crop | 1 | [None] | [None]
NETHERSHARDS | forbidden | Nether Shards | 1 | [None] | [None]
GREEDY | forbidden | Enchantment: Capitalist | 2 | [NETHERSHARDS, INFUSIONENCHANTMENT] | [None]
ROD_witchwood_staff | forbidden | Witchwood Staff Core | 2 | [ROD_silverwood_staff, ROD_witchwood] | [None]
EDUCATIONAL | forbidden | Enchantment: Educational | 2 | [INFUSIONENCHANTMENT] | [None]
ROD_profane | forbidden | Profane Wand | 1 | [NETHERSHARDS] | [None]
CAP_elementium | forbidden | Elementium Caps | 3 | [ROD_dreamwood_staff] | [None]
ROD_witchwood | forbidden | Witchwood Wand Core | 3 | [SCHOOLS, ROD_silverwood, INFUSION] | [None]
ROD_blood_wood | forbidden | Blood Infused Wood Cores | 2 | [ROD_blood] | [None]
TAINTSHOVEL | forbidden | Shovel of the Purifier | 2 | [THAUMIUM, INFUSION, ETHEREALBLOOM] | [None]
FOCUSBLINK | forbidden | Wand Focus: Blink | 2 | [NETHERSHARDS, INFUSION] | [None]

=======[taintedmagic]=======
VOIDFORTRESS | taintedmagic | Void Fortress Armour | 2 | [TMELDRITCHMAJOR] | [ARMORVOIDFORTRESS, ARMORFORTRESS]
CAP_cloth | taintedmagic | Enchanted Cloth Caps | 1 | [None] | [CAP_gold, ENCHFABRIC]
SHADOWCLOTH | taintedmagic | Shadow-Imbued Cloth | 1 | [ENCHFABRIC, SHADOWMETAL] | [None]
VOIDWALKERBOOTS | taintedmagic | Boots of the Voidwalker | 3 | [TMELDRITCHMAJOR] | [PRIMPEARL, BOOTSTRAVELLER, SHADOWCLOTH, ARMORVOIDFORTRESS]
GATEKEY | taintedmagic | Celestial Gate Key | 3 | [CREATION] | [INFUSION]
VISHROOMCRAFT | taintedmagic | Vishroom Transmutation | 1 | [None] | [None]
INSCRIPTIONFIRE | taintedmagic | Raging Demon Inscription | 1 | [THAUMIUMKATANA] | [FOCUSFIRE]
SHADOWMETAL | taintedmagic | Shadow Metal | 1 | [TAINTEDMAGIC] | [None]
VOIDGOGGLES | taintedmagic | Void Metal Goggles of Revealing | 1 | [WARPEDGOGGLES] | [VOIDMETAL]
HOLLOWDAGGER | taintedmagic | Hollow Dagger | 2 | [TAINTEDMAGIC] | [ENCHFABRIC, ESSENTIACRYSTAL, ELDRITCHMINOR]
FOCUSLUMOS | taintedmagic | Wand Focus: Lumos | 1 | [None] | [FOCUSFIRE]
PRAETORARMOR | taintedmagic | Advanced Crimson Forgery | 2 | [KNIGHTROBES] | [CRIMSONROBES, TMELDRITCHMAJOR, VOIDMETAL]
TAINTFOCUS | taintedmagic | Wand Focus: Taint Swarm | 3 | [FOCUSSHARD] | [INFUSION, BOTTLETAINT]
VOIDSASH | taintedmagic | Voidwalker's Sash of Runic Shielding | 1 | [VOIDWALKERBOOTS] | [PRIMPEARL]
CRIMSONROBES | taintedmagic | Crimson Clothcraft | 2 | [HOLLOWDAGGER] | [None]
BREAKPEARL | taintedmagic | Primordial Pearl Fragmentation | 1 | [PRIMPEARL] | [None]
LUMOSRING | taintedmagic | Ring of Lumos | 2 | [FOCUSLUMOS] | [RUNICARMOR]
CRIMSONBLADE | taintedmagic | Crimson Blade | 1 | [PRAETORARMOR] | [INFUSION]
DIFFUSIONUPGRADE | taintedmagic | Tier 5 Upgrade: Diffusion | 1 | [ELDRITCHFOCUS] | [FOCALMANIPULATION]
ROD_warpwood_staff | taintedmagic | Warpwood Staff Core | 2 | [ROD_warpwood] | [CREATIONSHARD]
TAINTEDMAGIC | taintedmagic | A disturbing find | 1 | [None] | [None]
VOIDMETALKATANA | taintedmagic | Void Metal Fortress Blade | 3 | [VOIDFORTRESS] | [THAUMIUMKATANA]
VOIDBLOOD | taintedmagic | Void-infused Blood | 1 | [HOLLOWDAGGER] | [ELDRITCHMAJOR, BREAKPEARL]
KNIGHTROBES | taintedmagic | Crimson Forgery | 2 | [CRIMSONROBES] | [ELDRITCHMINOR]
CREATIONSHARD | taintedmagic | Shard of Creation | 3 | [TMELDRITCHMAJOR] | [PRIMPEARL]
TIMESALT | taintedmagic | Salis Aevus | 1 | [CREATION] | [INFUSION]
MACEFOCUS | taintedmagic | Wand Focus: Mage's Mace | 2 | [None] | [THAUMIUM, FOCUSFIRE]
FOCUSSHOCKWAVE | taintedmagic | Wand Focus: Shockwave | 1 | [None] | [FOCUSSHOCK]
ELDRITCHFOCUS | taintedmagic | Wand Focus: Dark Matter | 3 | [TMELDRITCHMAJOR] | [OUTERREV]
THAUMICDISASSEMBLER | taintedmagic | Thaumic Disassembler | 3 | [TMELDRITCHMAJOR] | [THAUMIUM, VOIDMETAL, PRIMPEARL]
WARPTREE | taintedmagic | Warpwood Tree | 3 | [UNBALANCEDSHARDS] | [None]
UNBALANCEDSHARDS | taintedmagic | Unbalanced Shards | 1 | [TAINTEDMAGIC] | [None]
INSCRIPTIONHEAL | taintedmagic | Benevolent Goddess Inscription | 1 | [THAUMIUMKATANA] | [BATHSALTS]
WARPEDGOGGLES | taintedmagic | Warped Goggles Of Revealing | 1 | [SHADOWMETAL] | [TAINTEDMAGIC, GOGGLES]
PRIMALBLADE | taintedmagic | Primal Blade | 3 | [CREATION] | [VOIDMETAL, PRIMALCRUSHER, UNBALANCEDSHARDS, HOLLOWDAGGER]
INSCRIPTIONTHUNDER | taintedmagic | Vengeful Spirit Inscription | 1 | [THAUMIUMKATANA] | [FOCUSSHOCKWAVE]
SHADOWFORTRESS | taintedmagic | Shadow Fortress Armour | 3 | [SHADOWMETAL] | [VOIDFORTRESS, TMELDRITCHMAJOR, UNBALANCEDSHARDS]
MAGICFUNGUAR | taintedmagic | Magic Funguar | 1 | [VISHROOMCRAFT] | [None]
THAUMIUMKATANA | taintedmagic | Thaumium Fortress Blade | 3 | [None] | [ARMORFORTRESS]
FOCUSSHARD | taintedmagic | Wand Focus: Vis Shard | 1 | [UNBALANCEDSHARDS] | [FOCUSFIRE]
SHADOWMETALKATANA | taintedmagic | Shadow Metal Fortress Blade | 3 | [SHADOWFORTRESS] | [VOIDMETALKATANA]
TMELDRITCHMAJOR | taintedmagic | Eldritch Revelation | 1 | [None] | [None]
CAP_shadowcloth | taintedmagic | Shadow-imbued Cloth Caps | 1 | [SHADOWCLOTH] | [CAP_cloth]
CREATION | taintedmagic | Creation | 1 | [CREATIONSHARD] | [None]
ROD_warpwood | taintedmagic | Warpwood Wand Rod | 3 | [WARPTREE, VOIDMETAL, PRIMPEARL, ROD_primal_staff] | [SHADOWMETAL]
FLYTECHARM | taintedmagic | Flyte Charm | 3 | [CREATION] | [VOIDSASH, PRIMALARROW]
SKYSALT | taintedmagic | Salis Tempestas | 1 | [CREATION] | [INFUSION]
CAP_crimsoncloth | taintedmagic | Crimson-stained Cloth Caps | 1 | [CRIMSONROBES] | [CAP_cloth]
CAP_shadowmetal | taintedmagic | Shadow Metal Wand Caps | 2 | [SHADOWMETAL, CAP_void, PRIMPEARL] | [INFUSION]

=======[thaumicbases]=======
TB.INFUSION | thaumicbases | Infusion | 2 | [DISTILESSENTIA] | [None]
TB.ROD_silverwood | thaumicbases | Silverwood Wand Core | 3 | [ROD_greatwood, INFUSION] | [None]
TB.Relocator | thaumicbases | Thaumic Relocation | 1 | [TB.LEVITATOR] | [None]
TB.AdvAlc | thaumicbases | Advanced Alchemical Furnace | 2 | [TB.THAUMIUM, TB.DISTILESSENTIA, TB.BELLOWS] | [None]
TB.ThaumicAnvil | thaumicbases | Thaumium Anvil | 2 | [TB.THAUMIUM] | [None]
TB.FLUXSCRUB | thaumicbases | Flux Scrubber | 1 | [VISPOWER, BELLOWS, TUBES] | [INFUSION]
TB.Vaporising | thaumicbases | Vaporising | 1 | [TB.INFUSIONENCHANTMENT, TB.Enchantments] | [None]
TB.Plax | thaumicbases | Plax | 1 | [TB.BasicPlants] | [None]
TB.Tobacco.Mining | thaumicbases | Miner's Tobacco | 1 | [TB.Tobacco] | [None]
TB.NodeFoci.Destr | thaumicbases | Manipulator Foci: Destruction | 1 | [TB.NodeMan] | [None]
TB.NodeLinker | thaumicbases | Node Linking | 3 | [TB.VISPOWER] | [None]
TB.NODESTABILIZERADV | thaumicbases | Advanced Node Stabilizer | 2 | [NODESTABILIZER] | [None]
TB.SimpleDublication | thaumicbases | Simple Duplication | 1 | [TB.CRUCIBLE] | [None]
TB.Knose | thaumicbases | Rosa Mysteria | 1 | [TB.Aurelia, TB.CrystalBlocks] | [None]
CAP_thauminite | thaumicbases | Thauminite Wand Caps | 2 | [TB.Thauminite] | [None]
TB.VoidAnvil | thaumicbases | Void metal Anvil | 2 | [TB.VOIDMETAL, TB.ThaumicAnvil] | [None]
TB.Bracelet.Reed | thaumicbases | Reed Bracelets | 2 | [TB.ROD_reed] | [None]
TB.Tobacco.Wispy | thaumicbases | Wispy Tobacco | 1 | [TB.Tobacco, TB.INFUSION] | [None]
TB.Bracelet.Greatwood | thaumicbases | Greatwood Bracelets | 1 | [TB.Bracelet.Gold, TB.ROD_greatwood] | [None]
TB.Campfire | thaumicbases | Thaumaturge's Campfire | 1 | [None] | [None]
TB.ROD_blaze | thaumicbases | Blaze Rod Wand Core | 2 | [ROD_greatwood, INFUSION] | [None]
TB.Thauminite | thaumicbases | Thauminite | 2 | [TB.THAUMIUM] | [None]
TB.Foci.Drain | thaumicbases | Wand Focus: Liquid Drain | 1 | [TB.INFUSION, TB.FOCUSEXCAVATION, TB.JARVOID] | [None]
TB.DecoBlocks | thaumicbases | Decorative Blocks | 1 | [None] | [None]
TB.HerobrinesScythe | thaumicbases | Scythe Of The White-Eyed One | 3 | [TB.VOIDMETAL] | [None]
TB.Revolver.Eldritch | thaumicbases | Revolver Upgrade: Eldritch | 1 | [TB.Revolver] | [None]
TB.NodeFoci.Bright | thaumicbases | Manipulator Foci: Brightness | 1 | [TB.NodeMan, TB.PRIMPEARL] | [None]
TB.Foci.Experience | thaumicbases | Wand Focus: Experience | 1 | [TB.INFUSION, TB.FOCUSEXCAVATION] | [None]
TB.Bracelet.Obsidian | thaumicbases | Obsidian Bracelets | 2 | [TB.ROD_obsidian] | [None]
TB.NodeMan | thaumicbases | Node Manipulation | 3 | [TB.INFUSION, TB.NODESTABILIZERADV, TB.VISPOWER] | [None]
TB.ENCHFABRIC | thaumicbases | Enchanted Fabric | 1 | [None] | [None]
TB.Tobacco.Tainted | thaumicbases | Tainted Tobacco | 1 | [TB.Tobacco] | [None]
TB.Bracelet.Silverwood | thaumicbases | Silverwood Bracelets | 1 | [TB.Bracelet.Greatwood, TB.ROD_silverwood] | [None]
TB.Revolver.Power | thaumicbases | Revolver Upgrade: Power | 1 | [TB.Revolver] | [None]
TB.Revolver.Efficiency | thaumicbases | Revolver Upgrade: Efficiency | 1 | [TB.Revolver] | [None]
TB.Revolver.Primal | thaumicbases | Revolver Upgrade: Primal | 1 | [TB.Revolver] | [None]
TB.Redlon | thaumicbases | Redlon | 3 | [TB.Metalleat] | [None]
TB.ROD_bone | thaumicbases | Bone Wand Core | 2 | [ROD_greatwood, INFUSION] | [None]
TB.Revolver.Knowledge | thaumicbases | Revolver Upgrade: Knowledge | 1 | [TB.Revolver] | [None]
TB.RainbowCacti | thaumicbases | Rainbow Cacti | 2 | [TB.Metalleat] | [None]
TB.Revolver.Tainted | thaumicbases | Revolver Upgrade: Tainted | 1 | [TB.Revolver] | [None]
TB.PRIMPEARL | thaumicbases | Primordial Pearl | 1 | [ELDRITCHMINOR] | [None]
TB.Revolver.Speed | thaumicbases | Revolver Upgrade: Speed | 1 | [TB.Revolver] | [None]
TB.Spike.Iron | thaumicbases | Iron Spikes | 1 | [TB.ENCHFABRIC] | [None]
TB.NetherSapling | thaumicbases | Nether Tree | 1 | [TB.GoldenOak] | [None]
TB.Revolver.Piercing | thaumicbases | Revolver Upgrade: Piercing | 1 | [TB.Revolver] | [None]
TB.Revolver.Silver | thaumicbases | Revolver Upgrade: Silver | 1 | [TB.Revolver] | [None]
TB.Bracelet.Primal | thaumicbases | Primal Bracelets | 3 | [TB.ROD_primal_staff, TB.Bracelet.Bone, TB.Bracelet.Quartz, TB.Bracelet.Ice, TB.Bracelet.Obsidian, TB.Bracelet.Blaze, TB.Bracelet.Reed, TB.Bracelet.Silverwood] | [None]
TB.Bracelet.Ice | thaumicbases | Ice Bracelets | 2 | [TB.ROD_ice] | [None]
TB.VoidSeed | thaumicbases | Void Seeds | 1 | [TB.VOIDMETAL] | [None]
TB.CryingObs | thaumicbases | Crying Obsidian | 2 | [TB.INFUSION] | [None]
ROD_tbthaumium | thaumicbases | Thaumic Wand Rod | 2 | [TB.THAUMIUM] | [None]
TB.INFUSIONENCHANTMENT | thaumicbases | Infusion Enchantment | 3 | [JARBRAIN] | [None]
TB.CRUCIBLE | thaumicbases | Basic Alchemy | 1 | [None] | [None]
TB.ROD_obsidian | thaumicbases | Obsidian Wand Core | 2 | [ROD_greatwood, INFUSION] | [None]
TB.SilverwoodPipe | thaumicbases | Silverwood Smoking Pipe | 1 | [TB.Tobacco, TB.INFUSION] | [None]
TB.SM | thaumicbases | Salis Mundus Duplication | 1 | [TB.CRUCIBLE, TB.Quicksilver, TB.Amber] | [None]
TB.Ashroom | thaumicbases | Primal Shrooms | 2 | [TB.Aurelia] | [None]
TB.ROD_primal_staff | thaumicbases | Staff Core of the Primal | 3 | [FOCUSPRIMAL] | [ROD_silverwood_staff, ROD_bone_staff, ROD_greatwood_staff, ROD_blaze_staff, ROD_reed_staff, ROD_obsidian_staff, ROD_quartz_staff, ROD_ice_staff]
TB.Quicksilver | thaumicbases | Making Quicksilver | 1 | [TB.CRUCIBLE] | [None]
TB.Revolver | thaumicbases | Thaumaturge's Arsenal | 3 | [TB.INFUSION] | [None]
TB.Revolver.Heavy | thaumicbases | Revolver Upgrade: Heavy | 1 | [TB.Revolver] | [None]
TB.Revolver.Dueling | thaumicbases | Revolver Upgrade: Dueling | 1 | [TB.Revolver] | [None]
TB.EntityDecAdv | thaumicbases | Entity Deconstructor Improvements | 1 | [TB.EntityDec] | [None]
TB.Revolver.Void | thaumicbases | Revolver Upgrade: Void | 1 | [TB.Revolver] | [None]
TB.Bracelet.Thaumium | thaumicbases | Thaumium Bracelets | 1 | [TB.Bracelet.Greatwood] | [None]
TB.NodeFoci.Stability | thaumicbases | Manipulator Foci: Stability | 1 | [TB.NodeMan] | [None]
TB.StrongEntropy | thaumicbases | Entropy Destruction | 3 | [TB.AdvancedEntropy] | [None]
TB.ROD_greatwood | thaumicbases | Greatwood Wand Core | 1 | [BASICTHAUMATURGY] | [None]
TB.NodeFoci.Unstable | thaumicbases | Manipulator Foci: Instability | 1 | [TB.NodeMan] | [None]
TB.DISTILESSENTIA | thaumicbases | Essentia Distillation | 1 | [NITOR, ALUMENTUM] | [None]
TB.PeacefulSapling | thaumicbases | Peaceful Tree | 1 | [TB.GoldenOak] | [None]
TB.Spike.Void | thaumicbases | Void Spikes | 2 | [TB.VOIDMETAL, TB.Spike.Thaumic] | [None]
TB.TaintMinor | thaumicbases | tc.research_name.TB.TaintMinor | 3 | [None] | [None]
TB.MagicTouch | thaumicbases | Magic Touch | 1 | [TB.INFUSIONENCHANTMENT, TB.Enchantments] | [None]
TB.Flaxium | thaumicbases | Fluxium | 2 | [TB.Aurelia] | [None]
TB.Lazullia | thaumicbases | Lazullia | 2 | [TB.Metalleat] | [None]
TB.ROD_quartz | thaumicbases | Quartz Wand Core | 2 | [ROD_greatwood, INFUSION] | [None]
TB.Bracelet.Void | thaumicbases | Void Bracelets | 3 | [TB.Bracelet.Silverwood] | [None]
TB.NodeFoci.Hunger | thaumicbases | Manipulator Foci: Hunger | 1 | [TB.NodeMan] | [None]
TB.AlchemyRestoration | thaumicbases | Alchemy Restoration | 1 | [TB.CRUCIBLE] | [None]
TB.EldritchBane | thaumicbases | Eldritch Bane | 1 | [TB.INFUSIONENCHANTMENT, TB.Enchantments] | [None]
TB.Tobacco | thaumicbases | Magical Tobacco | 3 | [TB.Plax] | [None]
TB.Tobacco.Saturating | thaumicbases | Saturating Tobacco | 1 | [TB.Tobacco] | [None]
TB.Metalleat | thaumicbases | Metalleat | 1 | [TB.BasicPlants] | [None]
TB.NodeFoci.Taint | thaumicbases | Manipulator Foci: Taint | 1 | [TB.NodeMan] | [None]
TB.Revolver.Accuracy | thaumicbases | Revolver Upgrade: Accuracy | 1 | [TB.Revolver] | [None]
TB.Revolver.Atropods | thaumicbases | Revolver Upgrade: Bane Of Atropods | 1 | [TB.Revolver] | [None]
TB.NodeFoci.Purity | thaumicbases | Manipulator Foci: Purity | 1 | [TB.NodeMan] | [None]
TB.Lucrite | thaumicbases | Lucrite | 1 | [TB.Metalleat, TB.SMB] | [None]
TB.BasicPlants | thaumicbases | Thaumic Nature | 1 | [TB.CRUCIBLE] | [None]
TB.Tainted | thaumicbases | Tainted | 1 | [TB.INFUSIONENCHANTMENT, TB.Enchantments] | [None]
TB.LEVITATOR | thaumicbases | Arcane Levitator | 1 | [NITOR] | [None]
TB.Foci.Flux | thaumicbases | Wand Focus: Flux Scrubber | 1 | [TB.INFUSION, TB.JARVOID, TB.FLUXSCRUB] | [None]
TB.Overchanter | thaumicbases | Overchanting | 3 | [TB.INFUSION] | [None]
TB.VISPOWER | thaumicbases | Harnessing Vis | 2 | [NODESTABILIZER] | [None]
TB.AdvancedEntropy | thaumicbases | Advanced Entropy Manufacturing | 1 | [TB.CRUCIBLE] | [None]
TB.SMB | thaumicbases | Salis Mundus Blocks | 1 | [TB.SM] | [None]
TB.BELLOWS | thaumicbases | Arcane Bellows | 1 | [INFERNALFURNACE] | [None]
TB.VOIDMETAL | thaumicbases | Void metal | 2 | [THAUMIUM, ELDRITCHMINOR] | [None]
TB.MasterEntropy | thaumicbases | Entropy Manufacturing Mastered! | 3 | [TB.AdvancedEntropy] | [None]
TB.Brazier | thaumicbases | Thaumaturge's Brazier | 1 | [TB.Campfire] | [None]
TB.Bracelet.Gold | thaumicbases | Gold Bracelet | 1 | [TB.Bracelet.Iron, TB.CAP_gold] | [None]
TB.Tobacco.Eldritch | thaumicbases | Eldritch Tobacco | 1 | [TB.Tobacco, TB.INFUSION] | [None]
TB.NodeFoci.Efficiency | thaumicbases | Manipulator Foci: Efficiency | 1 | [TB.NodeMan] | [None]
TB.CrystalBlocks | thaumicbases | Crystal Cluster Blocks | 1 | [TB.AlchemyRestoration] | [None]
TB.Bracelet.Blaze | thaumicbases | Blaze Bracelets | 2 | [TB.ROD_blaze] | [None]
TB.EntityDec | thaumicbases | Entity Deconstructor | 1 | [TB.INFUSION] | [None]
TB.Amber | thaumicbases | Making Amber | 1 | [TB.CRUCIBLE] | [None]
TB.Bracelet.Quartz | thaumicbases | Quartz Bracelets | 2 | [TB.ROD_quartz] | [None]
TB.Bracelet.Bone | thaumicbases | Bone Bracelets | 2 | [TB.ROD_bone] | [None]
TB.Bracelet.Iron | thaumicbases | Thaumic Bracelets | 1 | [None] | [None]
TB.ROD_reed | thaumicbases | Reed Wand Core | 2 | [ROD_greatwood, INFUSION] | [None]
TB.Tobacco.Sanity | thaumicbases | Relaxing Tobacco | 1 | [TB.Tobacco] | [None]
TB.EnderSapling | thaumicbases | Ender Tree | 1 | [TB.GoldenOak] | [None]
TB.ElderKnowledge | thaumicbases | Elder Knowledge | 1 | [TB.INFUSIONENCHANTMENT, TB.Enchantments] | [None]
TB.BloodyRobes | thaumicbases | Bloody Thaumaturge's Robes | 1 | [TB.Spike.Iron] | [None]
TB.Enchantments | thaumicbases | New Enchantments! | 1 | [None] | [None]
TB.Foci.Activation | thaumicbases | Wand Focus: Activation | 1 | [TB.INFUSION, TB.MIRRORHAND] | [None]
TB.Glieonia | thaumicbases | Glieonia | 2 | [TB.Aurelia] | [None]
TB.NodeFoci.Sinister | thaumicbases | Manipulator Foci: Sinister | 1 | [TB.NodeMan] | [None]
TB.CAP_gold | thaumicbases | Gold Wand Caps | 1 | [BASICTHAUMATURGY] | [None]
TB.Backprocessing | thaumicbases | Alchemy Backprocessing | 1 | [TB.AlchemyRestoration, TB.AdvancedEntropy] | [None]
TB.JARVOID | thaumicbases | Void Jar | 1 | [JARLABEL] | [None]
TB.Aurelia | thaumicbases | Aurelia | 1 | [TB.BasicPlants] | [None]
TB.Tobacco.Angry | thaumicbases | Angry Tobacco | 1 | [TB.Tobacco] | [None]
TB.ROD_ice | thaumicbases | Icy Wand Core | 2 | [ROD_greatwood, INFUSION] | [None]
TB.Pyrofluid | thaumicbases | Pyrofluid | 3 | [TB.CRUCIBLE] | [None]
TB.FOCUSEXCAVATION | thaumicbases | Wand Focus: Excavation | 2 | [FOCUSFIRE] | [None]
ROD_tbvoid | thaumicbases | Void Wand Rod | 3 | [ROD_tbthaumium, TB.VOIDMETAL] | [None]
TB.GoldenOak | thaumicbases | Thaumic Dendrology | 1 | [TB.INFUSION, TB.Briar] | [None]
TB.OreDestruction | thaumicbases | Ore Destruction | 3 | [TB.MasterEntropy] | [None]
TB.Tobacco.Wisdom | thaumicbases | Wisdom Tobacco | 1 | [TB.Tobacco] | [None]
TB.Spike.Thaumic | thaumicbases | Thaumic Spikes | 1 | [TB.THAUMIUM, TB.Spike.Iron] | [None]
TB.THAUMIUM | thaumicbases | Magical Metallurgy | 1 | [CRUCIBLE] | [None]
TB.NodeFoci.Speed | thaumicbases | Manipulator Foci: Speed | 1 | [TB.NodeMan] | [None]
TB.Briar | thaumicbases | Briar | 1 | [TB.Plax] | [None]
TB.MIRRORHAND | thaumicbases | Magical hand Mirror | 2 | [MIRROR] | [None]
TB.Revolver.EldritchBane | thaumicbases | Revolver Upgrade: Bane Of Eldritch | 1 | [TB.Revolver] | [None]

=======[thaumcraft]=======
WOODCOMPOUNDUPGRADERECIPES | thaumcraft | [Upgrade] Vis casting | 1 | [WOODCOMPOUNDMAGICALRECIPES] | [WOODARCANERECIPES]
WOODCRUCIBLEMAGICALRECIPES | thaumcraft | Adding some spices ! | 1 | [WOODCRUCIBLERECIPES] | [None]
WOODCRUCIBLEINSTRUMENTUMRECIPES | thaumcraft | Cutting through fibers | 1 | [WOODCRUCIBLERECIPES] | [None]
WOODCOMPOUNDMAGICALRECIPES | thaumcraft | Casting magical wood | 1 | [WOODCOMPOUNDRECIPES] | [None]
WOODARCANERECIPES | thaumcraft | Arcane Recipes | 1 | [None] | [None]
WOODCOMPOUNDMAGICALUPGRADERECIPES | thaumcraft | [Upgrade] Vis casting | 1 | [WOODCOMPOUNDMAGICALRECIPES] | [WOODCOMPOUNDUPGRADERECIPES]
WOODCRUCIBLERECIPES | thaumcraft | Crucible Recipes | 1 | [WOODARCANERECIPES] | [None]
WOODCOMPOUNDRECIPES | thaumcraft | Wand casting | 2 | [None] | [None]
TORCHBASICRECIPES | thaumcraft | Basic Recipes | 1 | [None] | [None]

=======[thaumicexploration]=======
DREAMCATCHER | thaumicexploration | Wispy Dreamcatcher | 2 | [TAINTBASICS] | [None]
ROD_NECROMANCER_staff | thaumicexploration | Necromancer's Staff Core | 3 | [ROD_greatwood_staff, TXROD_greatwood_staff] | [INFUSION]
CAP_MECHANIST | thaumicexploration | Mechanist's Wand Caps | 2 | [TXCAP_thaumium, CAP_thaumium] | [INFUSION, NODETAPPER2]
TXINFUSIONENCHANTMENT | thaumicexploration | Infusion Enchantment | 1 | [None] | [None]
TXBASICARTIFACE | thaumicexploration | Basic Artifacing | 1 | [None] | [None]
TALISMANFOOD | thaumicexploration | Talisman of Nourishment | 2 | [TXINFUSION, FLESHCURE] | [INFUSION, INFUSION]
CAP_SOJOURNER | thaumicexploration | Sojourner's Wand Caps | 2 | [TXCAP_thaumium, CAP_thaumium] | [INFUSION, WANDPED]
TXTALLOW | thaumicexploration | Magic Tallow | 1 | [None] | [None]
BRAINCURE | thaumicexploration | Brain Sanitization | 1 | [JARBRAIN, FLESHCURE, TXINFUSION] | [INFUSION, INFUSION]
ENCHBINDING | thaumicexploration | Enchantment: Binding | 1 | [TXINFUSIONENCHANTMENT, INFUSIONENCHANTMENT] | [None]
ENCHNIGHTVISION | thaumicexploration | Enchantment: Night Vision | 1 | [TXINFUSIONENCHANTMENT, INFUSIONENCHANTMENT] | [None]
METEORBOOTS | thaumicexploration | Boots of the Meteor | 2 | [TXBOOTSTRAVELLER, BOOTSTRAVELLER, FOCUSFIRE] | [INFUSION, INFUSION]
STABILIZERBELT | thaumicexploration | Thaumostatic Stabilizer | 1 | [INFUSION, TXINFUSION, HOVERHARNESS, TXHOVERHARNESS] | [INFUSION]
REPLICATOR | thaumicexploration | Thaumic Replicator | 3 | [DISTILESSENTIA, TXINFUSION, TXDISTILESSENTIA] | [INFUSION, INFUSION]
ROD_AMBER | thaumicexploration | Amber Wand Core | 2 | [TXROD_greatwood, ROD_obsidian, ROD_reed, ROD_blaze, ROD_ice, ROD_quartz, ROD_bone] | [INFUSION]
URN | thaumicexploration | Everfull Urn | 1 | [INFUSION, TXINFUSION] | [INFUSION, ARCANEEAR]
BURN | thaumicexploration | Everburn Urn | 1 | [URN] | [INFUSION, ARCANEEAR]
ROD_TRANSMUTATION | thaumicexploration | Transmutative Wand Core | 2 | [TXROD_greatwood, ROD_greatwood] | [INFUSION]
SOULBRAZIER | thaumicexploration | Soul Brazier | 1 | [None] | [INFUSION]
ROD_TRANSMUTATION_staff | thaumicexploration | Transmutative Staff Core | 2 | [TXROD_greatwood_staff, ROD_TRANSMUTATION] | [ROD_greatwood_staff]
TXHOVERHARNESS | thaumicexploration | Thaumostatic Harness | 1 | [None] | [None]
ENCHDISARM | thaumicexploration | Enchantment: Disarming | 1 | [TXINFUSIONENCHANTMENT, INFUSIONENCHANTMENT] | [None]
TXROD_greatwood | thaumicexploration | Greatwood Wand Core | 1 | [None] | [None]
TENTACLERING | thaumicexploration | Taintacle Ring | 2 | [TAINTBASICS] | [INFUSION]
JARSEAL | thaumicexploration | Seal of Jar Binding | 1 | [None] | [None]
DISCOUNTRINGS | thaumicexploration | Shard Rings | 1 | [BASICARTIFACE, TXBASICARTIFACE] | [None]
ROD_AMBER_staff | thaumicexploration | Amber Staff Core | 2 | [TXROD_greatwood_staff, ROD_AMBER] | [ROD_greatwood_staff]
TXROD_greatwood_staff | thaumicexploration | Magic Staves | 1 | [None] | [None]
TRASHJAR | thaumicexploration | Oblivion Jar | 2 | [TXJARVOID, JARVOID, INFUSION, TXINFUSION] | [INFUSION]
CRUCSOULS | thaumicexploration | Crucible of Souls | 3 | [DISTILESSENTIA, TXINFUSION, TXDISTILESSENTIA] | [INFUSION, BRAINCURE, INFUSION]
COMETBOOTS | thaumicexploration | Boots of the Comet | 2 | [TXBOOTSTRAVELLER, BOOTSTRAVELLER, FOCUSFROST] | [INFUSION, INFUSION]
THINKTANK | thaumicexploration | Think Tank | 3 | [BRAINCURE, RESEARCHER2] | [INFUSION, INFUSION]
TXINFUSION | thaumicexploration | Infusion | 1 | [None] | [None]
FLESHCURE | thaumicexploration | Flesh Purification | 1 | [TXTALLOW] | [TALLOW]
TXBOOTSTRAVELLER | thaumicexploration | Boots of the Traveler | 1 | [TXINFUSION] | [None]
FLOATCANDLE | thaumicexploration | Floating Candles | 1 | [TXTALLOW, TALLOW] | [None]
TAINTBASICS | thaumicexploration | Taint | 1 | [None] | [None]
TXJARVOID | thaumicexploration | Void Jar | 1 | [None] | [None]
TXDISTILESSENTIA | thaumicexploration | Essentia Distillation | 1 | [None] | [None]
TXCAP_thaumium | thaumicexploration | Thaumium Wand Caps | 1 | [None] | [None]

=======[thaumichorizons]=======
alchIncubation | thaumichorizons | Alchemical Incubation | 1 | [alcheponics] | [None]
blastPhial | thaumichorizons | Blast Phials | 1 | [essentiaInjection] | [None]
nightmareInfusion | thaumichorizons | Nightmare | 2 | [horseInfusion, LEVITATOR] | [None]
runicCreature | thaumichorizons | Runic Hide | 2 | [generalInfusion, RUNICAUGMENTATION] | [None]
horseInfusion | thaumichorizons | Horse Infusions | 2 | [generalInfusion] | [None]
chickenInfusion | thaumichorizons | Chicken Infusions | 1 | [generalInfusion] | [None]
focusAnimation | thaumichorizons | Wand Focus: Animation | 3 | [PRIMPEARL, golemPowder] | [None]
focusLiquefaction | thaumichorizons | Wand Focus: Liquefaction | 2 | [focusIllumination, FOCUSEXCAVATION] | [None]
focusDisintegration | thaumichorizons | Wand Focus: Disintegration | 2 | [focusLiquefaction, alchemite, LIQUIDDEATH] | [None]
cloneVillager | thaumichorizons | Reincarnation | 3 | [incarnationVat, soulAssembler] | [None]
alchemite | thaumichorizons | Alchemite | 2 | [None] | [ESSENTIACRYSTAL]
transductionAmplifier | thaumichorizons | Transduction Amplifier | 3 | [planarTheory] | [None]
planarTheory | thaumichorizons | Planar Theory | 3 | [VISPOWER, VOIDMETAL] | [None]
leviathan | thaumichorizons | Primordial Fossils | 1 | [pocketPlane] | [None]
pigInfusion | thaumichorizons | Pig Infusions | 1 | [generalInfusion] | [None]
instilledLoyalty | thaumichorizons | Instilled Loyalty | 2 | [generalInfusion] | [None]
fleshLeather | thaumichorizons | Flesh Hardening | 1 | [meatGrowth] | [None]
planarKeystone | thaumichorizons | Planar Gateways | 3 | [pocketPlane] | [None]
voidGolem | thaumichorizons | Voidling Golems | 1 | [wispSpawn] | [golemPowder]
eldritchFangs | thaumichorizons | Eldritch Fangs | 2 | [generalInfusion, VOIDMETAL] | [None]
lensFire | thaumichorizons | Arcane Lenses | 2 | [GOGGLES, INFUSION] | [None]
thaumiumBoat | thaumichorizons | Thaumium Boat | 1 | [greatwoodBoat, THAUMIUM] | [None]
nightmare | thaumichorizons | Musings on Life and Death | 1 | [cloneVillager] | [None]
focusIllumination | thaumichorizons | Wand Focus: Illumination | 1 | [FOCUSFIRE] | [None]
silverHeart | thaumichorizons | Silverwood Heart | 2 | [humanInfusion] | [None]
soulExtractor | thaumichorizons | Soul Sieve | 1 | [JARBRAIN, ENCHFABRIC] | [None]
vortexStabilizer | thaumichorizons | Vortex Attenuation | 2 | [planarTheory] | [None]
lensCase | thaumichorizons | Lens Case | 1 | [lensAir, lensWater, lensEarth, lensOrderEntropy, FOCUSPOUCH] | [None]
synthSkin | thaumichorizons | Synthskin | 2 | [humanInfusion] | [None]
lensEarth | thaumichorizons | Evanescent Lens | 1 | [lensFire] | [None]
mirrorAmulet | thaumichorizons | Mirrored Amulet | 2 | [cloneSelf] | [MIRROR]
focusContainment | thaumichorizons | Wand Focus: Containment | 3 | [None] | [DISTILESSENTIA, FOCUSPORTABLEHOLE]
pocketPlane | thaumichorizons | Pocket Plane | 3 | [planarRift, PRIMPEARL] | [None]
essentiaInjection | thaumichorizons | Blood Alchemy | 3 | [meatGrowth] | [THAUMATORIUM, INFUSION]
alternateGolemBell | thaumichorizons | Golemancer's Bell | 1 | [None] | [None]
catInfusion | thaumichorizons | Feline Infusions | 1 | [generalInfusion] | [None]
amphibious | thaumichorizons | Amphibious Breath | 2 | [humanInfusion] | [None]
selfInfusion | thaumichorizons | Self-Infusion | 3 | [generalInfusion, cloneSelf] | [None]
dogInfusion | thaumichorizons | Canine Infusions | 1 | [generalInfusion] | [None]
planarRift | thaumichorizons | New Horizons | 2 | [vortexStabilizer, transductionAmplifier] | [None]
crystalWand | thaumichorizons | Crystalline Wand | 2 | [planarRift] | [None]
portability | thaumichorizons | Portability | 2 | [generalInfusion] | [None]
lensAir | thaumichorizons | Kirlian Lens | 1 | [lensFire] | [None]
visDynamo | thaumichorizons | Vis Dynamo | 2 | [None] | [INFUSION, VISPOWER]
sheederInfusion | thaumichorizons | Sheeder | 2 | [sheepInfusion] | [None]
etherealShard | thaumichorizons | Ethereal Shard | 3 | [shardTrans] | [INFUSION, VISPOWER]
planarClouds | thaumichorizons | Planar Clouds | 1 | [pocketPlane] | [None]
essentiaDynamo | thaumichorizons | Essentia Dynamo | 2 | [visDynamo] | [INFUSION, VISPOWER, THAUMIUM]
injector | thaumichorizons | Injector | 1 | [blastPhial, BONEBOW] | [None]
lensOrderEntropy | thaumichorizons | Scholar's Lens | 1 | [lensFire] | [None]
chameleonSkin | thaumichorizons | Chameleon Skin | 2 | [humanInfusion] | [None]
nodeMonitor | thaumichorizons | Node Monitor | 1 | [INFUSION] | [None]
lensWater | thaumichorizons | Echo Lens  | 1 | [lensFire, ARCANEEAR] | [None]
cowInfusion | thaumichorizons | Cow Infusions | 1 | [generalInfusion] | [None]
alcheponics | thaumichorizons | Alcheponics | 1 | [None] | [None]
sheepInfusion | thaumichorizons | Sheep Infusions | 1 | [generalInfusion] | [None]
humanInfusion | thaumichorizons | Basic Human Infusions | 1 | [selfInfusion] | [None]
morphicFingers | thaumichorizons | Morphic Fingers | 2 | [humanInfusion] | [None]
incarnationVat | thaumichorizons | Incarnation | 2 | [healingVat] | [None]
wispSpawn | thaumichorizons | Wisp Propagation | 1 | [planarRift] | [None]
soulAssembler | thaumichorizons | Soulforge | 3 | [soulKnowledge] | [None]
infusionVat | thaumichorizons | Creature Infusion | 3 | [healingVat, INFUSION, focusContainment] | [None]
greatwoodBoat | thaumichorizons | Greatwood Boat | 1 | [None] | [None]
golemPowder | thaumichorizons | Animation Powder | 3 | [GOLEMTHAUMIUM, ADVANCEDGOLEM, incarnationVat] | [None]
spiderClimb | thaumichorizons | Spider Climb | 2 | [humanInfusion] | [None]
shardTrans | thaumichorizons | Shard Transmutation | 2 | [None] | [None]
warpedTumor | thaumichorizons | Warped Tumor | 3 | [humanInfusion] | [None]
recombinator | thaumichorizons | Teleological Recombinator | 3 | [planarTheory, PRIMPEARL] | [None]
soulKnowledge | thaumichorizons | Inspiratron | 2 | [soulExtractor] | [None]
healingVat | thaumichorizons | Curative Vat | 3 | [essentiaInjection, fleshLeather] | [None]
cloneSelf | thaumichorizons | Self-Reincarnation | 2 | [nightmare, PRIMPEARL] | [None]
generalInfusion | thaumichorizons | General Infusions | 1 | [infusionVat] | [None]
meatGrowth | thaumichorizons | Meat Growth | 2 | [alchIncubation] | [None]
voidPutty | thaumichorizons | Void Putty | 2 | [planarRift] | [None]

=======[thaumcraft]=======
ARCANECRYSTAL | thaumcraft | Arcane Crystals | 3 | [MERCURIALWAND] | [None]
NODEMODIFIER | thaumcraft | Node Modifier | 3 | [NODEJAR, INFUSION] | [None]
MINILITHWATCHFUL | thaumcraft | Watchful Eye [WIP] | 1 | [MINILITHBASE] | [None]
MINILITHFIRE | thaumcraft | Burning Sentry [WIP] | 1 | [MINILITHBASE] | [None]
UPGRADERECHARGE | thaumcraft | Recharge Crystal | 3 | [ARCANECRYSTAL, INFUSION, ROD_reed, ROD_blaze, ROD_obsidian, ROD_ice, ROD_quartz, ROD_bone] | [None]
UPGRADEDISCOUNT | thaumcraft | Vis Discount Crystal | 3 | [ARCANECRYSTAL, INFUSION, ENCHFABRIC] | [None]
UPGRADEDRAIN | thaumcraft | Drain Multiplier Crystal | 3 | [ARCANECRYSTAL, INFUSION, DISTILESSENTIA] | [None]
MERCURIALWAND | thaumcraft | Mercurial Crystal Wand | 3 | [MERCURIALROD] | [None]
ESSENTIAENGINE | thaumcraft | Essentia Engine | 2 | [INFERNALFURNACE] | [INFUSION]
MINILITHFLUX | thaumcraft | Flux Dissipator | 1 | [MINILITHBASE] | [None]
MINILITHHEAL | thaumcraft | Healing Sentry [WIP] | 1 | [MINILITHBASE] | [None]
MINILITHBASE | thaumcraft | The Microlith | 1 | [ARCANECRYSTAL] | [None]
VOIDCAGE | thaumcraft | Wand Focus Void Cage | 2 | [None] | [FOCUSFIRE]
WANDBENCH | thaumcraft | Wandbench | 3 | [ARCANECRYSTAL] | [None]
ETHEREALJAR | thaumcraft | Ethereal Jar | 3 | [JARVOID] | [None]
MINILITHZAP | thaumcraft | Electrocution Sentry [WIP] | 1 | [MINILITHBASE] | [None]
MERCURIALROD | thaumcraft | Mercurial Wand Core | 3 | [None] | [ROD_silverwood, INFUSION]
FERTILIZER | thaumcraft | Thaumic Fertilizer | 3 | [None] | [None]
UPGRADESTABILIZER | thaumcraft | Stabilizer Crystal [WIP] | 3 | [ARCANECRYSTAL, INFUSION] | [None]
UPGRADEPOTENCY | thaumcraft | Potency Crystal | 3 | [ARCANECRYSTAL, INFUSION] | [None]
MINILITHFROST | thaumcraft | Packed Ice Sentry [WIP] | 1 | [MINILITHBASE] | [None]
UPGRADECOMPOUND | thaumcraft | Compound Drain Crystal | 3 | [ARCANECRYSTAL, INFUSION] | [None]

=======[dh]=======
CAP_cotton | dh | dh.research_name.CAP_cotton | 1 | [None] | [None]
INFERIOIS_MUTANDIS | dh | Wand Focus: Inferiois Mutandis | 1 | [None] | [None]
ROD_rowan | dh | dh.research_name.ROD_rowan | 1 | [None] | [None]
ROD_alder | dh | dh.research_name.ROD_alder | 1 | [None] | [None]
VISC | dh | Vis and Witch Magic | 1 | [None] | [None]
CAP_koboldite | dh | dh.research_name.CAP_koboldite | 1 | [None] | [None]
ROD_hawthorn | dh | dh.research_name.ROD_hawthorn | 1 | [None] | [None]

=======[am2pg]=======
ASCENDED_ETHERIUM | am2pg | Ascended Etherium | 1 | [AM2PG] | [None]
WARPAMULET | am2pg | Amulet of Warped Will | 1 | [SUNSTONEALLOY] | [None]
AM2PG | am2pg | Ars Magica 2: PlayGround | 1 | [None] | [None]
INSIGHT | am2pg | Insight | 1 | [ELDRITCHMIND, BATHSALTS] | [None]
SUNSTONEALLOY | am2pg | Magic material: Sunstone Alloy Ingot | 1 | [AM2PG] | [None]
FLUXDISEASE | am2pg | Flux Disease | 1 | [AM2PG] | [None]
OUTERDAMAGE | am2pg | Outer Damage | 1 | [AM2PG] | [None]
ELDRITCHMIND | am2pg | Eldritch Mind | 1 | [OUTERDAMAGE] | [None]
ASPECTRING | am2pg | Ring of World Affection | 2 | [AM2PG] | [PRIMPEARL]
ROD_illusion | am2pg | Illusion Charmed Silverwood Wand Core | 1 | [ROD_silverMoon] | [None]
CAP_illusion | am2pg | Illusion Wand Caps | 1 | [CAP_sun] | [None]
MOONLIGHTHIDE | am2pg | Magic material: Moonlight Hide | 1 | [AM2PG] | [None]
DISTORTEDKNOWLEDGE | am2pg | Tier 3 Upgrade: Distorted Knowledge | 1 | [WARPAMULET, FOCUSSPELL] | [FOCALMANIPULATION]
ROD_silverMoon | am2pg | Moonlight Blessed Silverwood Wand Core | 1 | [MOONLIGHTHIDE] | [ROD_silverwood]
FOCUSSPELL | am2pg | Wand Focus: Spell | 1 | [AM2PG] | [WARDEDARCANA]
CAP_sun | am2pg | Sunstone Wand Caps | 1 | [SUNSTONEALLOY] | [None]

=======[railcraft]=======
RC_Crowbar | railcraft | Thaumium Crowbar | 3 | [None] | [THAUMIUM]
RC_Crowbar_Void | railcraft | Void metal Crowbar | 3 | [RC_Crowbar] | [VOIDMETAL]

=======[arcane_engineering]=======
AEFAKE_VOIDMETAL | arcane_engineering | Void metal | 1 | [None] | [None]
NODEDESTABILIZER | arcane_engineering | Node Destabilizer | 2 | [AEFAKE_NODESTABILIZER] | [None]
CHARGER | arcane_engineering | Crystalline Charger | 2 | [ROD_upgradeable, DISTILESSENTIA, INFUSION, ROD_primal_staff] | [None]
CAPACITOR | arcane_engineering | Vis Capacitor | 2 | [ROD_upgradeable, DISTILESSENTIA, THAUMIUM] | [None]
CAP_electrum | arcane_engineering | Electrum Wand Caps | 1 | [AEFAKE_BASICTHAUMATURGY] | [None]
AEFAKE_BASICTHAUMATURGY | arcane_engineering | Basic Wand Craft | 1 | [None] | [None]
IMPULSEBOOTS | arcane_engineering | Impulse Boots | 1 | [None] | [None]
MAGITECH | arcane_engineering | Magical Technology | 1 | [None] | [None]
CAP_steel | arcane_engineering | Steel Wand Caps | 1 | [AEFAKE_BASICTHAUMATURGY] | [None]
DRILLVOID | arcane_engineering | Void Drill Head | 2 | [DRILLTHAUMIUM, AEFAKE_VOIDMETAL] | [None]
AEFAKE_NODESTABILIZER | arcane_engineering | Node Stabilizer | 1 | [None] | [None]
ROD_upgradeable | arcane_engineering | Treated Wood Wand Core | 1 | [AEFAKE_BASICTHAUMATURGY] | [None]
ENERGIZER | arcane_engineering | Focus Energizer | 3 | [ROD_upgradeable, PRIMPEARL, INFUSION] | [None]
DRILLTHAUMIUM | arcane_engineering | Thaumium Drill Head | 2 | [AEFAKE_THAUMIUM] | [None]
AEFAKE_THAUMIUM | arcane_engineering | Magical Metallurgy | 1 | [None] | [None]

=======[automagy]=======
REDCRYSTAL | automagy | Redcrystal | 1 | [REDSTONETHEORY] | [None]
GOLEMLINKER | automagy | Golem Linking Bell | 1 | [GOLEMINHIBITOR] | [INFUSION, UPGRADEORDER, GOLEMBELL]
NETHERRUNE_WISP | automagy | Runed Obsidian: Wisp | 1 | [DIMENSIONLURE] | [None]
MOBLURE | automagy | Siren's Lure | 2 | [NETHERMIND] | [INFUSION]
DIMENSIONLURE | automagy | Dimensional Lure | 2 | [MOBLURE, ENTITYSIGNAL] | [INFUSION]
ADVNODEJAR | automagy | Advanced Node Jarring | 3 | [None] | [NODEJAR, FOCUSWARDING, WARDEDARCANA]
TALLYBLOCK_LENS | automagy | Tally Box Lenses | 1 | [TALLYBLOCK] | [None]
NETHERRUNE_GHAST | automagy | Runed Obsidian: Ghast | 1 | [DIMENSIONLURE] | [None]
NETHERRUNE_BAT | automagy | Runed Obsidian: Bat | 1 | [DIMENSIONLURE] | [None]
SLIVERS_TRAVEL | automagy | Slivers for Travel | 1 | [SLIVERS] | [PAVETRAVEL]
REMOTECOMPARATOR | automagy | Remote Comparator | 1 | [REDCRYSTAL] | [None]
ESSENTIALOCUSAGGREGATOR | automagy | Essentia Aggregator | 1 | [ESSENTIALOCUS] | [MIRRORESSENTIA, JARVOID, INFUSION]
MIRRORINPUT | automagy | Melding Mirror | 2 | [None] | [MIRROR, VOIDMETAL, REMOTECOMPARATOR, INFUSION]
REDCRYSTAL_DIM | automagy | Dim Redcrystal | 1 | [REDCRYSTAL] | [None]
REDCRYSTAL_MIRRORBOUND | automagy | Mercurial Redcrystal | 2 | [REDCRYSTAL_RES] | [MIRROR]
THIRSTYTANK | automagy | Thirsty Tank | 2 | [GREEDYCHEST] | [None]
EAGERCHEST | automagy | Eager Chest | 1 | [AVARICIOUS, ENCHANTEDPAPER] | [None]
THIRSTYTANK_GLYPH_BOVINE | automagy | Glyph of the Bovine | 2 | [THIRSTYTANK_GLYPH] | [ENTITYSIGNAL]
NETHERRUNE_LIGHT | automagy | Runed Obsidian: Light | 1 | [NETHERMIND] | [None]
HUNGRYMAW | automagy | Hungry Maw | 1 | [HUNGRYCHEST, FOCUSPORTABLEHOLE] | [None]
ALCHEMYBOILER | automagy | Alchemical Boiler | 2 | [None] | [DISTILESSENTIA]
ENTITYSIGNAL | automagy | Signum Entia | 2 | [CRYSTALBRAIN] | [INFUSION]
NETHERRUNE_SLIME | automagy | Runed Obsidian: Slime | 1 | [DIMENSIONLURE] | [None]
NETHERRUNE_ZOMBIE | automagy | Runed Obsidian: Zombie | 1 | [DIMENSIONLURE] | [TALLOW]
XPSTONE | automagy | Soul Stone | 1 | [AMNESIASTONE] | [None]
GREEDYCHEST | automagy | Greedy Chest | 1 | [HUNGRYCHEST] | [None]
GOLEMWORKBENCH | automagy | Golem's Workbench | 1 | [ENCHANTEDPAPER] | [COREEMPTY, INFUSION]
NETHERRUNE_SOUL | automagy | Runed Obsidian: Soul | 1 | [NETHERMIND] | [None]
MIRRORMULTIDEST | automagy | Dispersing Mirror | 2 | [MIRRORINPUT, INVENTARIUM_DELIVERY] | [INFUSION]
ENDERDISJUNCTION | automagy | Ender Disjunction | 2 | [AVARICIOUS] | [INFUSION]
INVENTARIUM_DELIVERY | automagy | Supply and Demand | 2 | [INVENTARIUM] | [GOLEMLINKER, GOLEMINHIBITOR, NITORLIGHT, INFUSION]
SLIVERS | automagy | Slivers of Magic | 1 | [None] | [None]
ENCHANT_FISHING | automagy | Fishing Enchantments | 1 | [None] | [INFUSIONENCHANTMENT]
NETHERRUNE_CELERITY | automagy | Runed Obsidian: Celerity | 1 | [NETHERMIND] | [GREEDYCHEST]
THIRSTYTANK_GLYPH | automagy | Thirsty Glyphs | 1 | [THIRSTYTANK] | [AVARICIOUS]
CRYSTALBRAIN | automagy | Crystalline Brain | 3 | [REMOTECOMPARATOR] | [None]
VISHROOMSOUP | automagy | Vishroom Oddities | 1 | [None] | [None]
NITORLIGHT | automagy | Glowing Amber | 1 | [None] | [NITOR]
INVENTARIUM | automagy | Inventarium | 1 | [CRYSTALBRAIN, TALLYBLOCK] | [VISPOWER, INFUSION]
INVENTARIUM_POINTER | automagy | Scrivener's Oculus | 1 | [INVENTARIUM] | [None]
REDCRYSTAL_RES | automagy | Resonating Redcrystal | 2 | [None] | [REDCRYSTAL]
ENTROPICREFINING | automagy | Entropic Refining | 1 | [None] | [ENTROPICPROCESSING]
GOLEMWORKBENCH_UPGRADE | automagy | Workbench Upgrades | 1 | [GOLEMWORKBENCH] | [UPGRADEAIR, UPGRADEEARTH, UPGRADEFIRE, UPGRADEWATER, UPGRADEORDER, UPGRADEENTROPY]
FOCUSCRAFTING | automagy | Wand Focus: Crafting | 1 | [None] | [FOCUSFIRE]
ENCHANTEDPAPER | automagy | Enchanted Paper | 1 | [GREEDYCHEST] | [None]
AUTOHANDMIRROR | automagy | Hungry Hand Mirror | 1 | [FINICALMAW] | [MIRRORHAND]
REDSTONETHEORY | automagy | Redstone Theory | 1 | [None] | [None]
NETHERRUNE_SKELETON | automagy | Runed Obsidian: Skull | 1 | [DIMENSIONLURE] | [None]
ESSENTIALOCUS | automagy | Essentia Locus | 1 | [CRYSTALBRAIN, VISREADER] | [TUBES, GOGGLES, INFUSION]
MAGICHOURGLASS | automagy | Magic Hourglass | 1 | [REDCRYSTAL] | [None]
AMNESIASTONE | automagy | Amnesiac's Stone | 1 | [GOLEMINHIBITOR, JARBRAIN] | [None]
FOCUSCRAFTING_UPGRADE | automagy | Crafting Focus Upgrades | 2 | [FOCUSCRAFTING] | [FOCALMANIPULATION]
REDCRYSTAL_AMP | automagy | Amplified Redcrystal | 1 | [REDCRYSTAL] | [None]
INVENTARIUM_EXTRA | automagy | Condensed Archives | 1 | [INVENTARIUM] | [None]
NETHERRUNE_CRYSTAL | automagy | Runed Obsidian: Crystal | 1 | [NETHERMIND] | [None]
THAUMOSTATICREFUELER | automagy | Thaumostatic Spire | 2 | [CRYSTALBRAIN] | [HOVERHARNESS, VISPOWER, THAUMIUM, DISTILESSENTIA, INFUSION]
TALLYBLOCK | automagy | Tally Box | 1 | [REMOTECOMPARATOR, ENCHANTEDPAPER] | [None]
NETHERMIND | automagy | Nethermind | 1 | [CRYSTALBRAIN] | [GREEDYCHEST, VISPOWER, DISTILESSENTIA, INFUSION]
VISREADER | automagy | Vis Reader | 1 | [REMOTECOMPARATOR, DISTILESSENTIA] | [None]
FINICALMAW | automagy | Finical Maw | 1 | [HUNGRYMAW, ENCHANTEDPAPER] | [None]
AVARICIOUS | automagy | Structured Avarice | 1 | [GREEDYCHEST] | [None]
TENACIOUSCHEST | automagy | Tenacious Chest | 1 | [AVARICIOUS] | [None]
REDCRYSTAL_DENSE | automagy | Dense Redcrystal | 1 | [REDCRYSTAL] | [None]
SLIVERS_WARDING | automagy | Slivers for Warding | 1 | [SLIVERS] | [PAVEWARD]
GOLEMINHIBITOR | automagy | Golemic Inhibitor | 2 | [CRYSTALBRAIN] | [GOLEMFETTER, THAUMIUM]

=======[cybersus]=======
SIN_HEART | cybersus | Sin Heart | 1 | [BLANK_HEART] | [INFUSION]
BLANK_MOTHERBOARD | cybersus | empty motherboard | 3 | [PORTABLE_ASPECT_HOLDERS] | [INFUSION]
MIND_EXPLODER | cybersus | Mind-exploder | 2 | [BLANK_MOTHERBOARD] | [INFUSION]
GRAVITY_INCREASER | cybersus | Gravity Booster | 3 | [PORTABLE_ASPECT_HOLDERS] | [INFUSION]
PORTABLE_ASPECT_HOLDERS | cybersus | Portable aspect storage | 3 | [CYBERSUS_BASIC_INFO] | [INFUSION, INFUSION]
BERSERK_HEART | cybersus | Berserk Heart | 2 | [BLANK_HEART] | [INFUSION]
SLEEP_MODULE | cybersus | Sleep Module | 2 | [BLANK_MOTHERBOARD] | [INFUSION]
PHOENIX_HEART | cybersus | Phoenix heart | 1 | [BLANK_HEART] | [INFUSION]
CYBERSUS_BASIC_INFO | cybersus | Magic Prosthetics | 1 | [None] | [None]
BLANK_EYE | cybersus | Eye Implantation | 2 | [PORTABLE_ASPECT_HOLDERS] | [INFUSION]
BLANK_HEART | cybersus | Empty heart | 2 | [PORTABLE_ASPECT_HOLDERS] | [INFUSION]
SHADOW_SKIN | cybersus | Cover of shadows | 3 | [PORTABLE_ASPECT_HOLDERS] | [INFUSION]
ILLUSION_GENERATOR | cybersus | Illusion Generator | 2 | [BLANK_EYE] | [INFUSION]
TORMENTOR | cybersus | Tormentor | 3 | [BLANK_MOTHERBOARD] | [INFUSION]

=======[emt]=======
Thaumium Plate | emt | Thaumium Plate | 1 | [None] | [None]
Kris-tmas Focus | emt | Kris-tmas Focus | 1 | [Electric Magic Tools] | [None]
Macerating Native Ore Clusters | emt | Macerating Native Ore Clusters | 1 | [None] | [None]
Diamond Chainsaw | emt | Diamond Chainsaw | 1 | [None] | [None]
Auram Generator | emt | Auram Generator | 1 | [Potentia Generator] | [None]
Fire Infused Solar Panels | emt | Fire Infused Solar Panels | 1 | [Compressed Solars] | [None]
Mjolnir | emt | Mjolnir | 3 | [None] | [INFUSION, Electric Magic Tools]
UU-Matter Infusion | emt | UU-Matter Infusion | 3 | [None] | [INFUSION, INFUSION, INFUSION, INFUSION, INFUSION, INFUSION, INFUSION, INFUSION, INFUSION, INFUSION, INFUSION, INFUSION, INFUSION, INFUSION, Electric Magic Tools]
Electric Goggles | emt | Electric Goggles | 1 | [Electric Magic Tools] | [None]
Solar Helmet of Revealing | emt | Solar Helmet of Revealing | 1 | [Compressed Solars] | [INFUSION, Quantum Goggles of Revealing]
Potentia Generator | emt | Potentia Generator | 3 | [Electric Magic Tools] | [INFUSION]
Nano Boots of the Traveller | emt | Nano Boots of the Traveller | 2 | [Electric Boots of the Traveller] | [INFUSION]
Explosion Focus | emt | Explosion Focus | 2 | [Electric Magic Tools] | [INFUSION]
Electric Hoe of Growth | emt | Electric Hoe of Growth | 2 | [Electric Magic Tools] | [INFUSION]
Quantum Wings | emt | Quantum Wings | 3 | [Nanosuit Wings] | [INFUSION]
The Legend | emt | The Legend | 1 | [None] | [None]
Etheral Processor | emt | Etheral Processor | 2 | [Electric Magic Tools] | [INFUSION]
Aer Generator | emt | Aer Generator | 1 | [Potentia Generator] | [None]
Infused Quantum Armor | emt | Infused Quantum hestplate. | 3 | [Quantum Wings] | [INFUSION]
Compressed Solars | emt | Compressed Solars | 2 | [None] | [INFUSION, Potentia Generator]
Armor Charging Ring | emt | Armor Charging Ring | 3 | [Inventory Charging Ring] | [INFUSION]
Thaumium Chainsaw | emt | Thaumium Chainsaw | 1 | [Electric Magic Tools] | [INFUSION]
Inventory Charging Ring | emt | Inventory Charging Ring | 3 | [None] | [INFUSION, Electric Magic Tools]
Thaumium Drill | emt | Thaumium Drill | 1 | [Electric Magic Tools] | [INFUSION]
Portable Node | emt | Portable Node | 3 | [Electric Magic Tools] | [None]
The One Ring | emt | The One Ring | 1 | [None] | [None]
Thaumium Omnitool | emt | Thaumium Omnitool | 2 | [Diamond Omnitool] | [INFUSION, INFUSION, Thaumium Drill, Thaumium Chainsaw]
Water Infused Solar Panels | emt | Water Infused Solar Panels | 1 | [Compressed Solars] | [None]
Ignis Generator | emt | Ignis Generator | 1 | [Potentia Generator] | [None]
Quantum Goggles of Revealing | emt | Quantum Goggles of Revealing | 3 | [Nanosuit Goggles of Revealing] | [INFUSION]
Electric Cloud | emt | Electric Cloud | 1 | [None] | [None]
Chainsaw of the Stream | emt | Chainsaw of the Stream | 3 | [Thaumium Chainsaw] | [INFUSION]
Nanosuit Goggles of Revealing | emt | Nanosuit Goggles of Revealing | 2 | [Electric Goggles] | [INFUSION]
Feather Wings | emt | Feather Wings | 1 | [Electric Magic Tools] | [None]
Wand Focus: Charging | emt | Wand Focus: Charging | 2 | [Electric Magic Tools] | [INFUSION]
Shield Focus | emt | Shield Focus | 2 | [Electric Magic Tools] | [INFUSION]
Thaumium Reinforced Wings | emt | Thaumium Reinforced Wings | 1 | [Feather Wings] | [None]
Energy Ball Focus | emt | Energy Ball Focus | 2 | [Electric Magic Tools] | [INFUSION]
Electric Magic Tools | emt | Electric Magic Tools | 1 | [None] | [None]
Arbor Generator | emt | Arbor Generator | 1 | [Potentia Generator] | [None]
Lightning Summoner | emt | Lightning Summoner | 1 | [None] | [None]
Entropy Infused Solar Panels | emt | Entropy Infused Solar Panels | 1 | [Compressed Solars] | [None]
Electric Boots of the Traveller | emt | Electric Boots of the Traveller | 1 | [Electric Magic Tools] | [INFUSION]
Electric Scribing Tools | emt | Electric Scribing Tools | 1 | [None] | [Electric Magic Tools]
Shield Block | emt | Shield Block | 1 | [Shield Focus] | [None]
Nanosuit Wings | emt | Nanosuit Wings | 2 | [Thaumium Reinforced Wings] | [INFUSION]
Diamond Omnitool | emt | Diamond Omnitool | 1 | [Iron Omnitool] | [None]
Air Infused Solar Panels | emt | Air Infused Solar Panels | 1 | [Compressed Solars] | [None]
Wand Focus: Wand Charging | emt | Wand Focus: Wand Charging | 3 | [Wand Focus: Charging] | [INFUSION]
Order Infused Solar Panels | emt | Order Infused Solar Panels | 1 | [Compressed Solars] | [None]
Drill of the Rockbreaker | emt | Drill of the Rockbreaker | 3 | [Thaumium Drill] | [INFUSION]
Supercharged Mjolnir | emt | Supercharged Mjolnir | 3 | [Mjolnir] | [INFUSION]
Industrial Wand Charging Station | emt | Industrial Wand Charging Station | 3 | [Potentia Generator] | [INFUSION]
Earth Infused Solar Panels | emt | Earth Infused Solar Panels | 1 | [Compressed Solars] | [None]
Iron Omnitool | emt | Iron Omnitool | 1 | [Electric Magic Tools] | [None]
Quantum Boots of the Traveller | emt | Quantum Boots of the Traveller | 3 | [Nano Boots of the Traveller] | [INFUSION]
Tiny Uranium | emt | Tiny Uranium | 1 | [None] | [Electric Magic Tools]

=======[essenthaum]=======
et.research.pureLeft | essenthaum | Pure Particle | 3 | [et.research.pearlDivsion] | [None]
et.research.wandCharger | essenthaum | Wand Charger | 3 | [et.research.aspectProcessor] | [None]
et.research.mruSpreader | essenthaum | MRU Redistribution | 3 | [et.research.mruLeft] | [None]
et.research.mruLeft | essenthaum | Primordial MRU Leftovers | 3 | [et.research.pearlDivsion] | [None]
et.research.infusedStone | essenthaum | Aspect Fortification | 3 | [et.research.matrix] | [None]
et.research.aspectTransvector | essenthaum | Aspect Direction | 3 | [et.research.mruVol3] | [None]
et.research.chunkLoader | essenthaum | MRU Chunk Loader | 3 | [et.research.infusedStone] | [None]
et.research.foci_light | essenthaum | Wand Focus: MRU Lights | 3 | [et.research.matrix] | [None]
et.research.foci_lifedrain | essenthaum | Wand Focus: MRU Lifedrain | 3 | [et.research.matrix] | [None]
et.research.foci_sanity | essenthaum | Wand Focus: MRU Stabilizer | 3 | [et.research.matrix] | [None]
et.research.auraStabiliser | essenthaum | Aura Stabilizer | 3 | [et.research.infusedStone] | [None]
et.research.primordial | essenthaum | Primordial Pearl Leftovers | 3 | [et.research.pearlDivsion] | [None]
et.research.pearlDivsion | essenthaum | Primordial Pearl Division | 3 | [et.research.mruVol5, PRIMPEARL] | [None]
et.research.auraSpoiler | essenthaum | MRU Aura Spoiler | 3 | [et.research.auraStabiliser] | [None]
et.research.mrucuStabilizer | essenthaum | MRUCU Stabilization | 3 | [et.research.primordial] | [None]
et.research.dimTranciever | essenthaum | MRU Dimensional Transceiver | 3 | [et.research.infusedStone] | [None]
et.research.aspectProcessor | essenthaum | Aspects & MRU Unification | 3 | [et.research.mruVol3] | [None]
et.research.inkwellmru | essenthaum | MRU Powered Ink Well | 1 | [et.research.mruVol1] | [None]
et.research.nodeIrradiation | essenthaum | Aura Node Irradiation | 3 | [et.research.mruLeft] | [None]
ROD_mru | essenthaum | MRU Wand Core | 3 | [et.research.aspectTransvector] | [None]
CAP_mru | essenthaum | MRU Caps | 3 | [et.research.aspectTransvector] | [None]
et.research.crystalDestructor | essenthaum | Crystal Destruction | 3 | [et.research.aspectProcessor] | [None]
et.research.fluxWiper | essenthaum | Flux Wiper | 3 | [et.research.mruLeft] | [None]
et.research.foci_fortification | essenthaum | Wand Focus: MRU Fortification | 3 | [et.research.matrix] | [None]
et.research.matrix | essenthaum | MRU Matrix | 3 | [et.research.mruVol2] | [None]
et.research.mrucuAbsorber | essenthaum | MRUCU Absorption | 3 | [et.research.primordial] | [None]
et.research.mruVol3 | essenthaum | MRU Volume 3 | 3 | [et.research.mruVol2, INFUSION] | [None]
et.research.mruVol4 | essenthaum | MRU Volume 4 | 3 | [et.research.mruVol3, ELDRITCHMINOR] | [None]
et.research.mruVol5 | essenthaum | MRU Volume 5 | 3 | [et.research.mruVol4] | [None]
et.research.mruVol1 | essenthaum | MRU Volume 1 | 1 | [None] | [None]
et.research.generator | essenthaum | MRU Generator | 3 | [et.research.aspectProcessor] | [None]
ROD_mruStaff_staff | essenthaum | MRU Staff Core | 3 | [et.research.aspectTransvector] | [None]
et.research.mruVol2 | essenthaum | MRU Volume 2 | 2 | [et.research.mruVol1] | [None]
et.research.foci_infusion | essenthaum | Wand Focus: MRU Infusion | 3 | [et.research.matrix] | [None]
et.research.foci_ender | essenthaum | Wand Focus: MRU Teleportation | 3 | [et.research.matrix] | [None]
et.research.shadeLeft | essenthaum | Shade Particle | 3 | [et.research.pearlDivsion] | [None]

=======[thaumcraft]=======
essentiapipes:PIPES_BASIC | thaumcraft | Essentia Pipes | 1 | [None] | [THAUMATORIUM]
essentiapipes:PIPES_THAUMIUM | thaumcraft | Thaumium-Reinforced Essentia Pipes | 1 | [essentiapipes:PIPES_BASIC, THAUMIUM] | [None]
essentiapipes:PIPES_VOIDMETAL | thaumcraft | Voidmetal-Reinforced Essentia Pipes | 2 | [essentiapipes:PIPES_THAUMIUM, ESSENTIARESERVOIR] | [None]

=======[forgottenrelics]=======
OblivionStone | forgottenrelics | Keystone of The Oblivion | 1 | [SuperpositionRing] | [VOIDMETAL, SINSTONE]
NuclearFury | forgottenrelics | Nuclear Fury | 3 | [ChaosTome] | [PRIMPEARL]
SpellbookTheory | forgottenrelics | Basics of Spellbook Mastery | 1 | [GenericTheory] | [CRIMSON]
FateTome | forgottenrelics | Tome of Broken Fates | 3 | [SpellbookTheory] | [ELDRITCHMAJOR]
SuperpositionRing | forgottenrelics | Ring of Superposition | 2 | [GenericTheory] | [ELDRITCHMINOR]
Thunderpeal | forgottenrelics | Thunderpeal | 2 | [SpellbookTheory] | [DiscordTome, FOCUSSHOCK, FOCALMANIPULATION]
DiscordTome | forgottenrelics | Tome of Discord | 2 | [SpellbookTheory] | [FOCUSPORTABLEHOLE]
DimensionalMirror | forgottenrelics | Dimensional Mirror | 2 | [GenericTheory] | [MIRRORHAND, FOCUSPORTABLEHOLE, DeificAmulet]
DarkSunRing | forgottenrelics | Ring of The Seven Suns | 3 | [SuperpositionRing] | [ELDRITCHMINOR, NITOR, RUNICCHARGED]
SoulTome | forgottenrelics | Edict of a Thousand Damned Souls | 3 | [ObeliskDrainer] | [JARBRAIN]
XPTome | forgottenrelics | Tome of Ageless Wisdom | 2 | [WeatherStone] | [JARBRAIN, NITOR]
LunarFlares | forgottenrelics | Tome of Lunar Flares | 3 | [TelekinesisTome] | [EldritchSpell, PRIMPEARL]
ChaosTome | forgottenrelics | Tome of The Primal Chaos | 2 | [EldritchSpell] | [ROD_primal_staff]
FalseJustice | forgottenrelics | False Justice | 3 | [None] | [Apotheosis]
ObeliskDrainer | forgottenrelics | Devourer of The Void | 3 | [DiscordTome] | [ELDRITCHMAJOR, VOIDMETAL, ENCHFABRIC, NITOR, OCULUS]
ChaosCore | forgottenrelics | Chaos Core | 2 | [OblivionStone] | [ALUMENTUM, AncientAegis]
OblivionAmulet | forgottenrelics | Amulet of The Oblivion | 3 | [XPTome] | [OblivionStone, TerrorCrown, PRIMPEARL]
AncientAegis | forgottenrelics | Ancient Aegis | 1 | [SuperpositionRing] | [RUNICKINETIC, ENCHFABRIC]
TerrorCrown | forgottenrelics | Crown of Terror | 3 | [XPTome] | [ELDRITCHMAJOR, OCULUS]
CrimsonSpell | forgottenrelics | Crimson Spell | 3 | [EldritchSpell] | [INFUSION]
NebulousCore | forgottenrelics | Nebulous Core | 3 | [DeificAmulet] | [PRIMPEARL, VISAMULET, SuperpositionRing, THAUMIUM]
Overthrower | forgottenrelics | Edict of Eternal Banishment | 2 | [DiscordTome] | [FOCUSHELLBAT]
DiscordRing | forgottenrelics | Ring of Discord | 2 | [DeificAmulet] | [DiscordTome]
EldritchSpell | forgottenrelics | Eldritch Spell | 2 | [ObeliskDrainer] | [INFUSION]
ShinyStone | forgottenrelics | Shiny Stone | 2 | [DeificAmulet] | [INFUSION]
AdvancedMiningCharm | forgottenrelics | Ethereal Mining Charm | 2 | [MiningCharm] | [INFUSION]
GenericTheory | forgottenrelics | Theory of Eternal Artifacts | 1 | [None] | [INFUSION, THAUMIUM]
TheParadox | forgottenrelics | The Paradox | 1 | [SuperpositionRing] | [ChaosCore, PRIMPEARL]
PechFocus | forgottenrelics | Wand Focus: Pech's Curse | 2 | [WeatherStone] | [FOCUSFIRE, FOCUSFROST]
TelekinesisTome | forgottenrelics | Tome of Predestiny | 2 | [DiscordTome] | [ELDRITCHMINOR, Thunderpeal]
Apotheosis | forgottenrelics | The Apotheosis | 2 | [DiscordTome] | [LunarFlares, SoulTome, NuclearFury, CrimsonSpell, FateTome, NebulousCore, OblivionAmulet, TheParadox, Overthrower, DarkSunRing, ShinyStone, DimensionalMirror]
MiningCharm | forgottenrelics | Mining Charm | 1 | [GenericTheory] | [ELEMENTALPICK]
VoidGrimoire | forgottenrelics | Grimoire of The Abyss | 3 | [Overthrower] | [OCULUS, TerrorCrown, ChaosCore]
WeatherStone | forgottenrelics | Runic Stone | 1 | [GenericTheory] | [DeificAmulet]
DeificAmulet | forgottenrelics | Deific Amulet | 3 | [MiningCharm] | [RUNICEMERGENCY]

=======[gadomancy]=======
GADOMANCY.ARCANEDROPPER | gadomancy | Arcane Dropper | 2 | [DISTILESSENTIA, GADOMANCY.PSEUDO.BELLOWS] | [None]
ELEMENTALPICK | gadomancy | Pickaxe of the Core | 0 | [None] | [None]
GADOMANCY.AURA.motus | gadomancy | tc.research_name.GADOMANCY.AURA.motus | 0 | [None] | [None]
GADOMANCY.AURA.sano | gadomancy | tc.research_name.GADOMANCY.AURA.sano | 0 | [None] | [None]
ELEMENTALSHOVEL | gadomancy | Shovel of the Earthmover | 0 | [None] | [None]
GADOMANCY.E_PORTAL_CREATOR | gadomancy | Gate of the Voidwalkers | 2 | [GADOMANCY.NODE_MANIPULATOR, GADOMANCY.PSEUDO.OCULUS] | [None]
GADOMANCY.AURA.venenum | gadomancy | tc.research_name.GADOMANCY.AURA.venenum | 0 | [None] | [None]
GADOMANCY.AURA.luxuria | gadomancy | tc.research_name.GADOMANCY.AURA.luxuria | 0 | [None] | [None]
BOOTSTRAVELLER | gadomancy | Boots of the Traveler | 0 | [None] | [None]
GADOMANCY.AURA.auram | gadomancy | tc.research_name.GADOMANCY.AURA.auram | 0 | [None] | [None]
GADOMANCY.AURA.tenebrae | gadomancy | tc.research_name.GADOMANCY.AURA.tenebrae | 0 | [None] | [None]
GADOMANCY.KNOWLEDGE_BOOK | gadomancy | Book of Knowledge | 2 | [GADOMANCY.AURA_CORE, GOGGLES, THAUMATORIUM] | [None]
GADOMANCY.AURA.praecantatio | gadomancy | tc.research_name.GADOMANCY.AURA.praecantatio | 0 | [None] | [None]
GADOMANCY.GOLEMCOREBREAK | gadomancy | Golem Core: Break | 3 | [GADOMANCY.PSEUDO.COREHARVEST, ELEMENTALAXE, ELEMENTALPICK, ELEMENTALSHOVEL] | [None]
GADOMANCY.AURA.lucrum | gadomancy | tc.research_name.GADOMANCY.AURA.lucrum | 0 | [None] | [None]
GADOMANCY.AURA.lux | gadomancy | tc.research_name.GADOMANCY.AURA.lux | 0 | [None] | [None]
GADOMANCY.PSEUDO.VOIDMETAL | gadomancy | Void metal | 2 | [None] | [VOIDMETAL]
GADOMANCY.AURA_CORE | gadomancy | Aura Core | 2 | [INFUSION, THAUMIUM] | [None]
GADOMANCY.AURA_PYLON | gadomancy | Aura Pylon | 2 | [GADOMANCY.AURA_CORE, TUBEFILTER] | [None]
GADOMANCY.AURA.perditio | gadomancy | tc.research_name.GADOMANCY.AURA.perditio | 0 | [None] | [None]
GADOMANCY.AURA.cognitio | gadomancy | tc.research_name.GADOMANCY.AURA.cognitio | 0 | [None] | [None]
GADOMANCY.AURA.vinculum | gadomancy | tc.research_name.GADOMANCY.AURA.vinculum | 0 | [None] | [None]
PAVEWARD | gadomancy | Paving Stone of Warding | 0 | [None] | [None]
GADOMANCY.AURA.infernus | gadomancy | tc.research_name.GADOMANCY.AURA.infernus | 0 | [None] | [None]
GADOMANCY.ESSENTIA_COMPRESSOR | gadomancy | Essentia Condenser | 2 | [GADOMANCY.AURA_CORE, GADOMANCY.PSEUDO.ESSENTIARESERVOIR] | [None]
GADOMANCY.AURA.ignis | gadomancy | tc.research_name.GADOMANCY.AURA.ignis | 0 | [None] | [None]
GADOMANCY.GROWING_GROWTH | gadomancy | Growing Behavior | 3 | [GADOMANCY.GROWING] | [None]
GADOMANCY.AURA.mortuus | gadomancy | tc.research_name.GADOMANCY.AURA.mortuus | 0 | [None] | [None]
GADOMANCY.ARCANE_PACKAGER | gadomancy | Arcane Packager | 2 | [GADOMANCY.AURA_CORE, WARDEDARCANA] | [None]
GADOMANCY.AURA.iter | gadomancy | tc.research_name.GADOMANCY.AURA.iter | 0 | [None] | [None]
GADOMANCY.PSEUDO.COREGUARD | gadomancy | Golem Core: Guard | 2 | [None] | [COREGUARD]
GADOMANCY.AURA.vitium | gadomancy | tc.research_name.GADOMANCY.AURA.vitium | 0 | [None] | [None]
GADOMANCY.AURA.sensus | gadomancy | tc.research_name.GADOMANCY.AURA.sensus | 0 | [None] | [None]
GADOMANCY.GOLEMCOREBODYGUARD | gadomancy | Golem Core: Bodyguard | 2 | [BOOTSTRAVELLER, ELEMENTALSWORD, GADOMANCY.PSEUDO.COREGUARD] | [None]
GADOMANCY.AURA.pannus | gadomancy | tc.research_name.GADOMANCY.AURA.pannus | 0 | [None] | [None]
GADOMANCY.AURA.volatus | gadomancy | tc.research_name.GADOMANCY.AURA.volatus | 0 | [None] | [None]
GADOMANCY.AURA.humanus | gadomancy | tc.research_name.GADOMANCY.AURA.humanus | 0 | [None] | [None]
GADOMANCY.AURA.victus | gadomancy | tc.research_name.GADOMANCY.AURA.victus | 0 | [None] | [None]
GADOMANCY.AURA.limus | gadomancy | tc.research_name.GADOMANCY.AURA.limus | 0 | [None] | [None]
GADOMANCY.REMOTEJAR | gadomancy | Mirrored Jars | 3 | [GADOMANCY.PSEUDO.JARLABEL, MIRRORESSENTIA] | [None]
GADOMANCY.AURA.tutamen | gadomancy | tc.research_name.GADOMANCY.AURA.tutamen | 0 | [None] | [None]
GADOMANCY.NODE_MANIPULATOR | gadomancy | Node Manipulator | 2 | [GADOMANCY.PSEUDO.VOIDMETAL, WANDPEDFOC, PAVEWARD, GADOMANCY.PSEUDO.WANDPED] | [None]
GADOMANCY.AURA.ira | gadomancy | tc.research_name.GADOMANCY.AURA.ira | 0 | [None] | [None]
GADOMANCY.FAMILIAR_SHOCK | gadomancy | Lightning Impact | 2 | [GADOMANCY.ETHEREAL_FAMILIAR] | [None]
GADOMANCY.FAMILIAR_DAMAGE | gadomancy | Arc Amplification | 2 | [GADOMANCY.ETHEREAL_FAMILIAR, VOIDMETAL] | [None]
GADOMANCY.FAMILIAR_RANGE | gadomancy | Sensitivity Boost | 2 | [GADOMANCY.ETHEREAL_FAMILIAR] | [None]
GADOMANCY.PSEUDO.COREHARVEST | gadomancy | Golem Core: Harvest | 2 | [None] | [COREHARVEST]
GADOMANCY.AURA.fames | gadomancy | tc.research_name.GADOMANCY.AURA.fames | 0 | [None] | [None]
GADOMANCY.AURA.tempestas | gadomancy | tc.research_name.GADOMANCY.AURA.tempestas | 0 | [None] | [None]
ELEMENTALAXE | gadomancy | Axe of the Stream | 0 | [None] | [None]
GADOMANCY.FAMILIAR_SPEED | gadomancy | Frequency Emission Overdrive | 2 | [GADOMANCY.FAMILIAR_DAMAGE, GADOMANCY.FAMILIAR_RANGE, PRIMPEARL] | [None]
GADOMANCY.ARMORDISGUISE | gadomancy | Armor Disguise | 1 | [GADOMANCY.PSEUDO.INFUSIONENCHANTMENT] | [None]
GADOMANCY.AURA.terra | gadomancy | tc.research_name.GADOMANCY.AURA.terra | 0 | [None] | [None]
GADOMANCY.AURA.arbor | gadomancy | tc.research_name.GADOMANCY.AURA.arbor | 0 | [None] | [None]
GADOMANCY.AURA.gelum | gadomancy | tc.research_name.GADOMANCY.AURA.gelum | 0 | [None] | [None]
GADOMANCY.PSEUDO.JARLABEL | gadomancy | Warded Jars and Labels | 1 | [None] | [JARLABEL]
GADOMANCY.GROWING | gadomancy | Growing Nodes | 3 | [GADOMANCY.NODE_MANIPULATOR] | [None]
GADOMANCY.AURA.vitreus | gadomancy | tc.research_name.GADOMANCY.AURA.vitreus | 0 | [None] | [None]
GADOMANCY.CLEAN_AURA_CORE | gadomancy | Core Cleaning | 1 | [GADOMANCY.AURA_CORE] | [None]
GADOMANCY.STICKYJAR | gadomancy | Sticky Jars | 2 | [GADOMANCY.PSEUDO.JARLABEL] | [None]
GADOMANCY.PSEUDO.ESSENTIARESERVOIR | gadomancy | Advanced Essentia Storage  | 2 | [None] | [ESSENTIARESERVOIR]
GADOMANCY.AURA.alienis | gadomancy | tc.research_name.GADOMANCY.AURA.alienis | 0 | [None] | [None]
GADOMANCY.PSEUDO.WANDPED | gadomancy | Wand Recharge Pedestal | 2 | [None] | [WANDPED]
FOCUSPRIMAL | gadomancy | Wand Focus: Primal | 0 | [None] | [None]
GADOMANCY.AURA.desidia | gadomancy | tc.research_name.GADOMANCY.AURA.desidia | 0 | [None] | [None]
GADOMANCY.FAMILIAR_POISON | gadomancy | Corrosive Venom | 2 | [GADOMANCY.ETHEREAL_FAMILIAR] | [None]
GADOMANCY.AURA_EFFECTS | gadomancy | Aura Effects | 2 | [GADOMANCY.AURA_PYLON] | [None]
GADOMANCY.AURA.gula | gadomancy | tc.research_name.GADOMANCY.AURA.gula | 0 | [None] | [None]
GADOMANCY.AURA.spiritus | gadomancy | tc.research_name.GADOMANCY.AURA.spiritus | 0 | [None] | [None]
GADOMANCY.AURA.telum | gadomancy | tc.research_name.GADOMANCY.AURA.telum | 0 | [None] | [None]
GADOMANCY.GROWING_ATTACK | gadomancy | Destroying Behavior | 3 | [GADOMANCY.GROWING] | [None]
GADOMANCY.GOLEMSILVERWOOD | gadomancy | Silverwood Golems | 3 | [GADOMANCY.PSEUDO.GOLEMTALLOW] | [None]
GADOMANCY.ETHEREAL_FAMILIAR | gadomancy | Ethereal Familiar | 2 | [RUNICARMOR] | [None]
WANDPEDFOC | gadomancy | Compound Recharge Focus | 0 | [None] | [None]
GADOMANCY.AURA.invidia | gadomancy | tc.research_name.GADOMANCY.AURA.invidia | 0 | [None] | [None]
GADOMANCY.AURA.perfodio | gadomancy | tc.research_name.GADOMANCY.AURA.perfodio | 0 | [None] | [None]
GADOMANCY.GROWING_GROWTHCLUE | gadomancy | Secrets of growth | 2 | [GADOMANCY.GROWING_AGGRESSION, GADOMANCY.GROWING_GROWTH, GADOMANCY.GROWING_ATTACK] | [None]
GADOMANCY.AURA.exanimis | gadomancy | tc.research_name.GADOMANCY.AURA.exanimis | 0 | [None] | [None]
GADOMANCY.AURA.fabrico | gadomancy | tc.research_name.GADOMANCY.AURA.fabrico | 0 | [None] | [None]
GADOMANCY.FAMILIAR_WEAKNESS | gadomancy | Enervation | 2 | [GADOMANCY.ETHEREAL_FAMILIAR] | [None]
GADOMANCY.AURA.bestia | gadomancy | tc.research_name.GADOMANCY.AURA.bestia | 0 | [None] | [None]
GADOMANCY.PSEUDO.OCULUS | gadomancy | Opening the Eye | 1 | [None] | [OCULUS]
GADOMANCY.AURA.potentia | gadomancy | tc.research_name.GADOMANCY.AURA.potentia | 0 | [None] | [None]
GADOMANCY.AURA.herba | gadomancy | tc.research_name.GADOMANCY.AURA.herba | 0 | [None] | [None]
COREUSE | gadomancy | Golem Core: Use | 0 | [None] | [None]
GADOMANCY.AURA.superbia | gadomancy | tc.research_name.GADOMANCY.AURA.superbia | 0 | [None] | [None]
GADOMANCY.INFUSIONCLAW | gadomancy | Automated Infusion | 3 | [FOCUSPRIMAL, GADOMANCY.PSEUDO.VOIDMETAL, GADOMANCY.PSEUDO.WANDPED, COREUSE] | [None]
GADOMANCY.GOLEMRUNICSHIELD | gadomancy | Golemic Shielding | 3 | [GADOMANCY.GOLEMSILVERWOOD] | [None]
GADOMANCY.PSEUDO.BELLOWS | gadomancy | Arcane Bellows | 1 | [None] | [BELLOWS]
GADOMANCY.BLOCK_PROTECTOR | gadomancy | Enervation Field Emitter | 2 | [GADOMANCY.STICKYJAR] | [None]
GADOMANCY.PSEUDO.INFUSIONENCHANTMENT | gadomancy | Infusion Enchantment | 3 | [None] | [INFUSIONENCHANTMENT]
RUNICARMOR | gadomancy | Runic Shielding | 0 | [None] | [None]
GADOMANCY.AURA.aer | gadomancy | tc.research_name.GADOMANCY.AURA.aer | 0 | [None] | [None]
GADOMANCY.AURA.ordo | gadomancy | tc.research_name.GADOMANCY.AURA.ordo | 0 | [None] | [None]
GADOMANCY.REVEALER | gadomancy | Thaumic Sight | 1 | [GADOMANCY.PSEUDO.INFUSIONENCHANTMENT, GOGGLES] | [None]
GADOMANCY.GROWING_AGGRESSION | gadomancy | Aggressive Behavior | 3 | [GADOMANCY.GROWING] | [None]
ELEMENTALSWORD | gadomancy | Sword of the Zephyr | 0 | [None] | [None]
GADOMANCY.AURA.aqua | gadomancy | tc.research_name.GADOMANCY.AURA.aqua | 0 | [None] | [None]
GADOMANCY.FAMILIAR_FIRE | gadomancy | Flash Burn | 2 | [GADOMANCY.ETHEREAL_FAMILIAR] | [None]
GADOMANCY.PSEUDO.GOLEMTALLOW | gadomancy | Tallow Golems | 2 | [None] | [GOLEMTALLOW]
GADOMANCY.AURA.instrumentum | gadomancy | tc.research_name.GADOMANCY.AURA.instrumentum | 0 | [None] | [None]

=======[mdeco]=======
FANCYLANTERN | mdeco | Thaumaturge's Lanterns | 1 | [None] | [None]
DECOMATRIX | mdeco | Decorative Runic Matrix | 1 | [FANCYLANTERN] | [None]

=======[magicbees]=======
MB_Scoop | magicbees | Thaumium Scoop | 1 | [None] | [THAUMIUM]
MB_EssenceTime | magicbees | Essence of Lost Time | 2 | [MB_EssenceUnstable] | [None]
MB_Root | magicbees | Apimancy | 1 | [None] | [None]
MB_EssenceArmor | magicbees | Essence of Everlasting Durability | 2 | [MB_EssenceLife] | [None]
MB_Grafter | magicbees | Thaumium Grafter | 2 | [MB_Scoop] | [None]
MB_EssenceLife | magicbees | Essence of False Life | 1 | [None] | [CRUCIBLE]
MB_EssenceOblivion | magicbees | Essence of Scornful Oblivion | 3 | [MB_DimensionalSingularity] | [None]
MB_VisAuraProvider | magicbees | Vis Apiary Booster | 3 | [None] | [VISPOWER]
MB_LoreFragment | magicbees | Lore Fragments | 1 | [MB_Root] | [None]
MB_FrameMagic | magicbees | Magic Frame | 1 | [None] | [None]
MB_EssenceUnstable | magicbees | Essence of Fickle Permanence | 2 | [MB_EssenceLife] | [None]
MB_EssenceDeath | magicbees | Essence of a Shallow Grave | 1 | [MB_EssenceUnstable] | [None]
MB_DimensionalSingularity | magicbees | Dimensional Singularity | 3 | [MB_FrameMagic, MB_EssenceTime, MB_EssenceDeath] | [None]

=======[magiccookie]=======
GOLEMGOLD | magiccookie | Golden Golems | 2 | [MANACOOKIE, ADVANCEDGOLEM] | [None]
DARKSTONE | magiccookie | Dark Brick | 3 | [BASICCRAFTING] | [None]
MASTERRINGORDO | magiccookie | Master's Ring of Order | 1 | [UPGRADEWATER, RUNICAUGMENTATION, ROD_quartz, MASTERRINGPERDITIO] | [MANACOOKIE]
WOOLTOSTRING | magiccookie | Pulling threads | 2 | [FLESHTOLEATHER] | [None]
MAGICICE | magiccookie | Magic Ice | 2 | [MANACOOKIE, INFUSION, FOCUSFROST] | [None]
ELEMENTALSHEARS | magiccookie | Shepherd's Shears | 1 | [THAUMIUM, INFUSION] | [None]
MASTERRINGAER | magiccookie | Master's Ring of Air | 1 | [UPGRADEAIR, RUNICAUGMENTATION, ROD_reed, MASTERRINGAQUA] | [MANACOOKIE]
ADVANCEDGOLEMBELL | magiccookie | Advanced GolemBell | 2 | [ADVANCEDGOLEM, MANACOOKIE] | [None]
VOIDCRYSTAL | magiccookie | Controlled Void Crystal | 3 | [MANACOOKIE, MIRRORHAND] | [None]
GOLEMEMERALD | magiccookie | Emerald Golem | 3 | [MANACOOKIE, ADVANCEDGOLEM] | [None]
QUICKSILVERSTORAGE | magiccookie | QuickSilver Container | 1 | [ETCHEDIRONCRAFT] | [None]
ETCHEDIRONCRAFT | magiccookie | Etched Iron | 2 | [ETCHEDIRON] | [None]
MASTERRINGIGNIS | magiccookie | Master's Ring of Fire | 1 | [UPGRADEFIRE, RUNICAUGMENTATION, MANACOOKIE, ROD_blaze] | [None]
GROG | magiccookie | Jug o' Grog | 3 | [None] | [None]
DECHANTMENTTABLE | magiccookie | Dechanting | 3 | [None] | [None]
FLESHTOLEATHER | magiccookie | From rags to Riches | 2 | [MANACOOKIE] | [None]
MASTERRINGONE | magiccookie | Master's One Ring | 1 | [MASTERRINGIGNIS, MASTERRINGAQUA, MASTERRINGTERRA, MASTERRINGAER, MASTERRINGORDO, MASTERRINGPERDITIO] | [None]
ACIDETCHEDIRON | magiccookie | Acid Etched Iron | 2 | [ETCHEDIRON] | [None]
BASICCRAFTING | magiccookie | Basic Crafting Skills | 1 | [NODESTABILIZERADV] | [None]
FOCUSICECAGE | magiccookie | Wand Focus: Heart of Ice | 3 | [MAGICICE] | [None]
SLICKSAND | magiccookie | Slipping through the cracks | 3 | [BASICCRAFTING] | [None]
MASTERRINGTERRA | magiccookie | Master's Ring of Earth | 1 | [UPGRADEEARTH, RUNICAUGMENTATION, ROD_obsidian, MASTERRINGORDO, MASTERRINGAER] | [MANACOOKIE]
MANACOOKIE | magiccookie | Mana Cookies | 1 | [INFUSION] | [None]
MASTERRINGAQUA | magiccookie | Master's Ring of Water | 1 | [UPGRADEWATER, RUNICAUGMENTATION, ROD_ice, MASTERRINGIGNIS] | [MANACOOKIE]
PURECINNABAR | magiccookie | Cinnabar Purification | 2 | [THAUMIUM, FLESHTOLEATHER] | [None]
MASTERRINGPERDITIO | magiccookie | Master's Ring of Entropy | 1 | [UPGRADEENTROPY, RUNICAUGMENTATION, ROD_bone, MASTERRINGIGNIS] | [MANACOOKIE]
GOLEMVOIDMETAL | magiccookie | Void Metal Golem | 1 | [ADVANCEDGOLEM, GOLEMGOLD, GOLEMEMERALD, ESSENTIARESERVOIR] | [None]
ETCHEDIRON | magiccookie | Etched Iron | 2 | [BASICCRAFTING] | [None]
DIDYOUIRONTHECAT | magiccookie | Did you iron the cat? | 3 | [VOIDCRYSTAL] | [None]

=======[manametalmod]=======
Mana | manametalmod | Mana | 1 | [None] | [None]
CAP_BEDROCK | manametalmod | Bedrock Cap | 1 | [ingotBedrock] | [None]
CAP_ANCIENTTHULIUM | manametalmod | Ancient Thulium Cap | 1 | [ingotAncientThulium] | [THAUMIUM, INFUSION]
ingotBedrock | manametalmod | Bedrock | 1 | [ingotAncientThulium] | [None]
ItemFocusMagicBallFire | manametalmod | Focus: Fireball | 1 | [None] | [THAUMIUM, INFUSION]
ItemFocusMagicBallDark | manametalmod | Spell Focus: Dark Sphere | 1 | [None] | [THAUMIUM, INFUSION]
ingotBloodMetal | manametalmod | Dark Blood | 1 | [ingotDark] | [None]
RecipeItemFocusMagicSet | manametalmod | tc.research_name.RecipeItemFocusMagicSet | 1 | [None] | [THAUMIUM, INFUSION]
CAP_PLATIUM | manametalmod | Platinum Cap | 1 | [None] | [None]
CAP_BLOODMETAL | manametalmod | Dark Blood Steel Cap | 1 | [ingotBloodMetal] | [None]
CAP_MANAS | manametalmod | Magic Steel Staff Cap | 1 | [ingotManaS] | [None]
CAP_DARK | manametalmod | Dark Steel Cap | 1 | [ingotDark] | [None]
ItemFocusMagicBallSuper | manametalmod | Spell Focus: Elemental Storm | 1 | [None] | [THAUMIUM, INFUSION]
ingotNeutronEnergy | manametalmod | O'Halloran Steel | 1 | [ingotEndless] | [None]
ingotAncientThulium | manametalmod | Ancient Thulium | 1 | [ingotRuneSteel] | [None]
CAP_PALLADIUM | manametalmod | Palladium Cap | 1 | [None] | [None]
ItemFocusMagicMana | manametalmod | Spell Focus: Mana Conversion | 1 | [None] | [THAUMIUM, INFUSION]
ingotUniverseEnergy | manametalmod | Cosmic Energy | 1 | [ingotNeutronEnergy] | [None]
ItemFocusMagicLightningS | manametalmod | Focus: Advanced Lightning | 1 | [None] | [THAUMIUM, INFUSION]
ingotEndless | manametalmod | Infinite Steel | 1 | [ingotCrimson] | [None]
CAP_UNIVERSEENERGY | manametalmod | Cosmic Energy Wand Cap | 1 | [ingotUniverseEnergy] | [None]
ingotManaS | manametalmod | Magic Steel | 1 | [Mana] | [None]
ItemFocusMagicGS | manametalmod | Focus: Super Gravity Sphere | 1 | [None] | [THAUMIUM, INFUSION]
ItemFocusMagicArrow | manametalmod | Spell Focus: Wind Arrow Storm | 1 | [None] | [THAUMIUM, INFUSION]
pearlMake | manametalmod | Pearl Awakening | 1 | [ingotUniverseEnergy] | [None]
ItemFocusMagicBallIce | manametalmod | Focus: Ice Ball | 1 | [None] | [THAUMIUM, INFUSION]
ingotRuneSteel | manametalmod | Rune Steel | 1 | [ingotManaS] | [None]
CAP_CRIMSON | manametalmod | Red Chain Metal Cap | 1 | [ingotCrimson] | [None]
ManaDUST | manametalmod | Magic Dust Alchemy | 1 | [Mana] | [None]
CAP_NEUTRONENERGY | manametalmod | O'Halloran Steel Wand Cap | 1 | [ingotNeutronEnergy] | [None]
CAP_ENDLESS | manametalmod | Infinite Steel Wand Cap | 1 | [ingotEndless] | [None]
ingotDark | manametalmod | Dark Metal | 1 | [ingotBedrock] | [None]
ItemFocusMagicDefense | manametalmod | Spell Focus: Grass Blessing | 1 | [None] | [THAUMIUM, INFUSION]
Astronomy | manametalmod | Astronomy | 1 | [None] | [None]
CAP_LEGEND | manametalmod | Rune Steel Staff Cap | 1 | [ingotRuneSteel] | [None]
ItemFocusMagicG | manametalmod | Focus: Gravity Sphere | 1 | [None] | [THAUMIUM, INFUSION]
ingotCrimson | manametalmod | Crimson | 1 | [ingotBloodMetal] | [None]

=======[manametalmod]=======
CrimsonBiography | manametalmod | Crimson Biography | 2 | [ShardMake] | [None]
ItemRuneMagicBauble1 | manametalmod | Transcendent Ring | 3 | [ShardMake] | [None]
ItemRuneMagicBauble2 | manametalmod | Galaxy Belt | 3 | [ShardMake] | [None]
ROD_magictree | manametalmod | Spirit Tree Wand Core | 3 | [MagicTreeMake] | [None]
MisriruArmor | manametalmod | Mithril Armor | 3 | [ingotMisriru] | [None]
ItemNodeMake | manametalmod | Light of Creation | 3 | [PaneMaker] | [None]
ItemRuneMagicBauble0 | manametalmod | Genesis Necklace | 3 | [ShardMake] | [None]
MagicTreeMake | manametalmod | Spirit Tree | 3 | [PearDustMake] | [None]
TrueMisriruArmor1 | manametalmod | Genesis Divine Chestplate | 3 | [ShardMake] | [None]
MagicFoodMake | manametalmod | Infusion Apple | 3 | [PearDustMake] | [None]
TrueMisriruArmor0 | manametalmod | Infernal Messenger Helmet | 3 | [ShardMake] | [None]
TrueMisriruArmor3 | manametalmod | Typhoon Goddess Boots | 3 | [ShardMake] | [None]
ingotMisriru | manametalmod | Misriru Ingot | 3 | [PearDustMake] | [None]
MagicXPMake | manametalmod | Genesis Essence | 3 | [PearDustMake] | [None]
TrueMisriruArmor2 | manametalmod | Earth Shield Leggings | 3 | [ShardMake] | [None]
UltimateThaumcraft | manametalmod | Ultimate Thaumcraft | 3 | [None] | [PRIMPEARL]
ItemPrimalCrusherTrues | manametalmod | True Primal Crusher | 3 | [ShardMake] | [None]
ContaminationCake | manametalmod | Contamination Slime Cake | 2 | [CrimsonBiography] | [None]
ShardMake | manametalmod | Genesis Shard | 3 | [ingotMisriru] | [None]
ROD_misriru | manametalmod | Misriru-Inlaid Silverwood Rod | 3 | [PaneMaker] | [None]
MagicItemThaumCrafts5 | manametalmod | Mithril Bracers | 3 | [MagicItemThaumCrafts0] | [None]
MagicItemThaumCrafts4 | manametalmod | Mithril Shoulder Guard | 3 | [MagicItemThaumCrafts0] | [None]
PanaceaMake | manametalmod | Panacea | 3 | [PearDustMake] | [None]
ROD_misrirubig_staff | manametalmod | Misriru-Inlaid Silverwood Staff Core | 3 | [ROD_misriru] | [None]
MagicItemThaumCrafts1 | manametalmod | Mithril Necklace | 3 | [MagicItemThaumCrafts0] | [None]
MagicItemThaumCrafts0 | manametalmod | Mithril Accessories | 3 | [ShardMake] | [None]
MagicItemThaumCrafts3 | manametalmod | Mithril Earrings | 3 | [MagicItemThaumCrafts0] | [None]
MagicItemThaumCrafts2 | manametalmod | Mithril Belt | 3 | [MagicItemThaumCrafts0] | [None]
ItemWorldDestroy | manametalmod | Flame of Destruction | 3 | [ItemNodeMake] | [None]
PaneMaker | manametalmod | Creation Pen | 3 | [ShardMake] | [None]
PearDustMake | manametalmod | Pearl Dust | 3 | [UltimateThaumcraft] | [None]

=======[manametalmod]=======

=======[thaumcraftrecipes]=======
ADDGREATWOOD | thaumcraftrecipes | Crafting Greatwood Sapling | 2 | [DESCRIPTION] | [None]
NITORFOCUS | thaumcraftrecipes | Wand Focus: Nitor | 2 | [DESCRIPTION, NITOR, INFUSION] | [None]
DESCRIPTION | thaumcraftrecipes | The Description of Synthesis | 3 | [None] | [None]
ADDMANABEAN | thaumcraftrecipes | Crafting Mana Bean | 1 | [ADDGREATWOOD, ADDSILVERWOOD] | [None]
PECH'SCURSEFOCUS | thaumcraftrecipes | Wand Focus: Pech's Curse | 3 | [ALUMENTUMSPAWNERFOCUS, NITORFOCUS] | [None]
ADDSILVERWOOD | thaumcraftrecipes | Crafting Silverwood Sapling | 3 | [ADDGREATWOOD, INFUSION] | [None]
ALUMENTUMSPAWNERFOCUS | thaumcraftrecipes | Wand Focus: Alumentum | 2 | [DESCRIPTION, ALUMENTUM, INFUSION] | [None]
TRANSMUTATIONFOCUS | thaumcraftrecipes | Wand Focus: Transmutation | 3 | [ALUMENTUMSPAWNERFOCUS, NITORFOCUS] | [None]

=======[thaumicdyes]=======
TD.RUNICBOOTSTRAVELLER | thaumicdyes | Runic Boots of the Traveller | 2 | [TD.BOOTSTRAVELLER, TD.RUNICARMOR] | [None]
TD.DYEDPRAETOR | thaumicdyes | Thaumaturge's Praetor Armor  | 3 | [TD.CRIMSONLEADER] | [None]
TD.RUNICGOGGLES | thaumicdyes | Runic Goggles of Revealing | 2 | [GOGGLES, TD.RUNICARMOR] | [None]
TD.ENHANCEDRUNICARMOR | thaumicdyes | Enhanced Runic Armor | 3 | [TD.RUNICARMOR] | [TD.RUNICARMORUPGRADES]
TD.CRIMSONBANNER | thaumicdyes | Crimson Cult Banner | 1 | [TD.CRIMSON, BANNERS] | [None]
TD.CRIMSONCLERIC | thaumicdyes | Crimson Cleric Robes | 1 | [TD.CRIMSON] | [None]
TD.RUNICARMORUPGRADES | thaumicdyes | Runic Armor Upgrades | 3 | [TD.RUNICARMOR] | [RUNICHEALING, RUNICKINETIC, RUNICEMERGENCY]
TD.PRIMALRUNICARMOR | thaumicdyes | Abyssal Runic Armor | 3 | [TD.ENHANCEDRUNICARMOR] | [PRIMPEARL]
TD.DYEDARCHER | thaumicdyes | Thaumaturge's Battledress | 2 | [TD.CRIMSONARCHER] | [None]
TD.VOIDROBE | thaumicdyes | Bleached Void Robes | 2 | [TD.VOIDFORTRESS] | [None]
TD.IRONHELMGOGGLES | thaumicdyes | Helm of Revealing | 1 | [TD.IRONFORTRESS, GOGGLES] | [None]
TD.CRIMSON | thaumicdyes | Crimson Armorsmithing | 2 | [CRIMSON, ENCHFABRIC] | [None]
TD.INHABITEDPLATE | thaumicdyes | Husk Armor | 2 | [TD.OUTERARRIVAL] | [None]
TD.MASKEVIL | thaumicdyes | Mask of Cruelty | 2 | [VOIDMETAL] | [None]
TD.VOIDFORTRESS | thaumicdyes | Void Thaumaturge Robes | 1 | [None] | [None]
TD.DYEDRANGER | thaumicdyes | Thaumaturge's Ranger Armor | 2 | [TD.CRIMSONRANGER] | [None]
TD.IRONFORTRESS | thaumicdyes | Iron Fortress Armor | 2 | [TD.ARMORFORTRESS] | [None]
TD.THAUMIUMBOOTS | thaumicdyes | Thaumium Boots of the Explorer | 2 | [TD.THAUMIUM, TD.BOOTSTRAVELLER] | [None]
TD.PRIMALRUNIC | thaumicdyes | Abyssal secrets | 1 | [TD.PRIMALRUNICARMOR] | [None]
TD.CRIMSONARCHER | thaumicdyes | Crimson Archer Armor | 1 | [TD.CRIMSON] | [TD.CRIMSONKNIGHT]
TD.DYEDFORTRESS | thaumicdyes | Enhanced Fortress Armor  | 2 | [TD.THAUMIUM, TD.ARMORFORTRESS] | [None]
TD.CRIMSONRANGER | thaumicdyes | Crimson Ranger Robes | 1 | [TD.CRIMSON] | [TD.CRIMSONCLERIC]
TD.PALADIN | thaumicdyes | Crimson Paladin | 1 | [TD.CRIMSONLEADER] | [TD.DYEDPRAETOR]
TD.THAUMIUM | thaumicdyes | Magical Metallurgy | 1 | [None] | [None]
TD.VOIDBOOTS | thaumicdyes | Void Boots of the Wanderer | 2 | [TD.VOIDFORTRESS, TD.BOOTSTRAVELLER] | [None]
TD.ARMORFORTRESS | thaumicdyes | Thaumium Fortress Armor | 1 | [None] | [None]
TD.DYEDROBE | thaumicdyes | Thaumaturge's Crimson Robes  | 2 | [TD.CRIMSONCLERIC] | [None]
TD.THAUMIUMROBE | thaumicdyes | Thaumium Robes | 2 | [TD.THAUMIUM, GOGGLES, ENCHFABRIC] | [None]
TD.CRIMSONLEADER | thaumicdyes | Crimson Praetor Armor | 2 | [TD.CRIMSON, PRIMPEARL] | [TD.CRIMSONCLERIC, TD.CRIMSONKNIGHT, TD.CRIMSONRANGER, TD.CRIMSONARCHER]
TD.DYEDKNIGHT | thaumicdyes | Thaumaturge's Knight Armor  | 2 | [TD.CRIMSONKNIGHT] | [None]
TD.RUNICARMOR | thaumicdyes | Runic Armor | 3 | [INFUSION, RUNICARMOR] | [None]
TD.BOOTSTRAVELLER | thaumicdyes | Boots of the Traveler | 1 | [None] | [None]
TD.IRONHELMAESTHETICS | thaumicdyes | Aesthetic Faceplates | 1 | [TD.IRONFORTRESS] | [None]
TD.CRIMSONKNIGHT | thaumicdyes | Crimson Knight Armor | 1 | [TD.CRIMSON] | [None]
TD.OUTERARRIVAL | thaumicdyes | The Outer Lands  | 1 | [None] | [None]
TD.IRONHELMHUSK | thaumicdyes | Husk Faceplate | 1 | [TD.IRONFORTRESS] | [TD.INHABITEDPLATE, TD.IRONHELMAESTHETICS]
TD.SUNNYD | thaumicdyes | Solaire's Gift | 1 | [None] | [TD.DYEDKNIGHT]

=======[thaum]=======
DYEDCRIM | thaum | Thaumaturge's Crimson Robes | 2 | [INFUSION] | [None]
DYEDPRAETER | thaum | Thaumic Praeter Armor | 3 | [DYEDCRIM] | [None]
DYEDFORTRESS | thaum | Enhanced Fortress Armor | 3 | [DYEDPRAETER] | [None]

=======[thaumicboots]=======
TB_Explorations_Tainted_Compat | thaumicboots | Eldritch Celestial Bodies | 1 | [TB_Explorations_Core, TB_Tainted_Core, TB_Core_Research] | [None]
TB_EMT_Tainted_Compat | thaumicboots | Artificial Void Magicks | 1 | [TB_Tainted_Core, TB_EMT_Core, TB_Core_Research] | [None]
TB_EMT_Core | thaumicboots | Artificial Magicks | 1 | [Electric Boots of the Traveller] | [None]
TB_Unique_Boots | thaumicboots | Unique Magicks | 1 | [TB_Core_Research] | [None]
TB_Core_Research | thaumicboots | Thaumaturgic Shoemaking | 1 | [THAUMIUM] | [None]
TB_Explorations_Core | thaumicboots | Celestial Magicks | 1 | [METEORBOOTS, COMETBOOTS] | [None]
TB_Explorations_Compat | thaumicboots | Combined Celestial Magicks | 1 | [TB_Core_Research, TB_Explorations_Core] | [None]
TB_Tainted_Core | thaumicboots | Void Magicks | 1 | [VOIDWALKERBOOTS] | [None]
TB_Seasonal_Boots | thaumicboots | Seasonal Magicks | 1 | [TB_Core_Research] | [None]
TB_Seasonal_Stabilized | thaumicboots | Stabilized Seasonal Magicks | 1 | [TB_Seasonal_Boots] | [None]
TB_Explorations_EMT_Compat | thaumicboots | Artificial Celestial Magicks | 1 | [TB_Core_Research, TB_Explorations_Core, TB_EMT_Core] | [None]

=======[thaumicconcilium]=======
BOTTLEWATER | thaumicconcilium | Bottle of Clear Water | 1 | [None] | [None]
PONTIFEXROBE | thaumicconcilium | Pontifex's Robes | 1 | [CRIMSONPONTIFEX, MATERIALPEELER] | [PRAETORARMOR]
SPOTLIGHTFOCI | thaumicconcilium | Wand Focus: Spotlight | 2 | [RINGOFBLUSTERINGLIGHT] | [None]
RIFTS | thaumicconcilium | Rifts | 1 | [None] | [None]
COOLINGFOCI | thaumicconcilium | Wand Focus: Cooling | 2 | [DESTCRYSTAL] | [None]
VALETCORE | thaumicconcilium | Golem Animation Core: Valet | 2 | [TCGADOMANCY] | [COREUSE, ARCANEEAR]
VISCONDUCTOR | thaumicconcilium | Wand Focus: Vis Conductor | 3 | [None] | [THAUMATURGES, INFUSION, VISPOWER, WANDPEDFOC]
SHARDMILL | thaumicconcilium | Shard Mill | 2 | [THAUMATURGES] | [ROD_greatwood, FOCUSFIRE]
ALCHEMISTSPREE | thaumicconcilium | Wand Focus: Alchemist's Spree | 3 | [RINGOFBLUSTERINGLIGHT] | [ADVALCHEMYFURNACE, THAUMATORIUM]
BLOODBRACELET | thaumicconcilium | Blood Bracelet | 2 | [TCBASES] | [TB.Bracelet.Iron, ROD_blood, CAP_alchemical]
XYLOGRAPHY | thaumicconcilium | Wand Xylography | 2 | [None] | [None]
LITHOGRAPHER | thaumicconcilium | Lithographer | 3 | [ASTRALMONITOR] | [ADVALCHEMYFURNACE]
RIFTGEM | thaumicconcilium | Gem of Rifts | 2 | [TCGADOMANCY, HEXOFPREDICTABILITY] | [GADOMANCY.AURA_CORE, WARDEDARCANA]
IMPULSEFOCI | thaumicconcilium | Wand Focus: Impulse | 2 | [SIGNALFOCI] | [None]
MATERIALPEELER | thaumicconcilium | Peeler of Matter | 1 | [CRIMSONPONTIFEX] | [CREATION]
DREAMWOODBRACELET | thaumicconcilium | Dreamwood Bracelet | 2 | [LIVINGWOODBRACELET, TCBASES] | [TB.Bracelet.Iron, ROD_dreamwood, CAP_elementium]
TCBOTTLETAINT | thaumicconcilium | Bottled Taint  | 1 | [None] | [None]
ASSISTANCECORE | thaumicconcilium | Golem Animation Core: Assistant | 2 | [TCGADOMANCY] | [COREALCHEMY, COREBUTCHER]
TIGHTBELT | thaumicconcilium | Tight Belt | 2 | [BOTTLEOFTHICKTAINT] | [HOVERGIRDLE, DESTCRYSTAL]
TERRACAST | thaumicconcilium | Terra-Cast Gem | 2 | [TCGADOMANCY, HEXOFPREDICTABILITY, RIFTGEM] | [GADOMANCY.AURA_CORE, WARDEDARCANA]
WARPWOODBRACELET | thaumicconcilium | Warpwood Bracelet | 2 | [TCBASES] | [TB.Bracelet.Iron, ROD_warpwood, CAP_shadowmetal]
FLESHCRUCIBLE | thaumicconcilium | Crucible of Flesh | 3 | [MATERIALPEELER] | [QUICKSILVERCRUCIBLE]
BURDENINGAMULET | thaumicconcilium | Burdening Amulet | 2 | [TIGHTBELT] | [SINSTONE]
VISCONDENSER | thaumicconcilium | Vis-Condenser | 1 | [DEMATUPGRADE] | [NODESTABILIZERADV]
SIGNALFOCI | thaumicconcilium | Wand Focus: Signal | 1 | [THAUMATURGES] | [FOCUSFIRE, INFUSION]
TAINTEDBRACELET | thaumicconcilium | Tainted Bracelet | 2 | [TCBASES] | [TB.Bracelet.Iron, ROD_tainted, CAP_thaumium]
BOTTLEOFTHICKTAINT | thaumicconcilium | Bottle of Thick Taint | 2 | [TCBOTTLETAINT] | [None]
TCBASES | thaumicconcilium | Thaumic Bases | 1 | [THAUMATURGES] | [TB.Bracelet.Iron]
THAUMATURGES | thaumicconcilium | Thaumaturges | 1 | [TCRESEARCHDUPE] | [None]
THAUMICCONCILIUM | thaumicconcilium | Thaumic Concilium | 1 | [THAUMATURGES] | [None]
TCTAINTEDMAGIC | thaumicconcilium | Tainted Magic | 1 | [THAUMATURGES] | [HOLLOWDAGGER]
CRIMSONSPELLS | thaumicconcilium | Spells from Crimson Cult | 1 | [CRIMSONPONTIFEX] | [None]
RUNICWINDINGS | thaumicconcilium | Runic Windings | 1 | [None] | [RUNICAUGMENTATION, CRYSTALWELL]
DOPESQUID | thaumicconcilium | Doped Squid | 2 | [TCHORIZONS] | [infusionVat, TB.Tobacco.Eldritch, TB.Tobacco.Wispy, TB.Tobacco.Angry, TB.Tobacco.Mining, TB.Tobacco.Wisdom, TB.Tobacco.Tainted, TB.Tobacco.Saturating, TB.Tobacco.Sanity]
CRIMSONANNALES | thaumicconcilium | Crimson Annales | 1 | [TCTAINTEDMAGIC] | [CRIMSON]
BUFFGOLEM | thaumicconcilium | Enlarged Thaumium Golem | 1 | [BRAINLITTERING] | [golemPowder, GOLEMTHAUMIUM, GOLEMFETTER]
HEXOFPREDICTABILITY | thaumicconcilium | Hex of Predictability | 3 | [VISCONDENSER] | [OUTERREV]
TERRASTEELBRACELET | thaumicconcilium | Terrasteel Bracelet | 2 | [TCBASES] | [TB.Bracelet.Iron, CAP_terrasteel]
RINGOFBLUSTERINGLIGHT | thaumicconcilium | Ring Of Blustering Light | 3 | [PRIMORDIALLIFE] | [PRIMPEARL, RUNICCHARGED, ICHOR]
SILVERWOODSHARDMILL | thaumicconcilium | Silverwood Shard Mill | 2 | [SHARDMILL] | [ROD_silverwood]
BRIGHTESTONE | thaumicconcilium | Exploring the Nature of Wisps | 2 | [HEXOFPREDICTABILITY] | [THAUMDRUM]
DEMATUPGRADE | thaumicconcilium | Focus Upgrade: Dematerialization | 1 | [RIFTS] | [VISCONDUCTOR, FOCALMANIPULATION]
TCAUTOMAGY | thaumicconcilium | tc.research_name.TCAUTOMAGY | 1 | [None] | [None]
DUMPJACKBOOTS | thaumicconcilium | Dump Jackboots | 2 | [DESTCRYSTAL] | [BOOTSTRAVELLER]
LIVINGWOODBRACELET | thaumicconcilium | Livingwood Bracelet | 2 | [TCBASES] | [TB.Bracelet.Iron, ROD_livingwood, CAP_manasteel]
WITCHWOODBRACELET | thaumicconcilium | Witchwood Bracelet | 2 | [TCBASES] | [TB.Bracelet.Iron, ROD_witchwood, CAP_vinteum]
REFLECTIONFOCI | thaumicconcilium | Wand Focus: Reflection | 3 | [DESTCRYSTAL] | [FOCUS_XP_DRAIN, ADVANCEDGOLEM]
TCHORIZONS | thaumicconcilium | Thaumic Horizons | 1 | [THAUMATURGES] | [healingVat]
WRATHATTRACTION | thaumicconcilium | Wand Focus: Wrath Attraction | 3 | [DESTCRYSTAL] | [None]
ASTRALMONITOR | thaumicconcilium | Astral Monitor | 3 | [HEXOFPREDICTABILITY] | [None]
POSITIVEBURSTFOCI | thaumicconcilium | Wand Focus: Positive Burst | 3 | [SIGNALFOCI] | [FOCUS_HEAL]
WARPDRUM | thaumicconcilium | Warped Drum | 2 | [THAUMDRUM] | [HEXOFPREDICTABILITY]
TAINTANIMATION | thaumicconcilium | Wand Focus: Taint Animation | 3 | [DESTCRYSTAL] | [BOTTLEOFTHICKTAINT, FOCUSHELLBAT, TAINTSHOVEL]
TCGADOMANCY | thaumicconcilium | Gadomancy | 1 | [THAUMATURGES] | [GADOMANCY.AURA_CORE]
PONTIFEXHAMMER | thaumicconcilium | Pontifex's Hammer | 1 | [CRIMSONPONTIFEX] | [CRIMSONBLADE]
MADTHAUMATURGES | thaumicconcilium | Mad Thaumaturges | 1 | [THAUMATURGES] | [None]
DRAINAGESYRINGE | thaumicconcilium | Drainage Syringe | 2 | [TCHORIZONS] | [injector, ESSENTIARESERVOIR]
SCRIBINGFOCI | thaumicconcilium | Wand Focus: Scribing | 3 | [RUNICWINDINGS] | [DESTCRYSTAL, FOCUSWARDING, BRIGHT_NITOR]
TCRESEARCHDUPE | thaumicconcilium | Research Duplication | 1 | [None] | [None]
CRIMSONPONTIFEX | thaumicconcilium | Crimson Pontifex | 1 | [CRIMSONANNALES] | [BRIGHTESTONE]
THAUMDRUM | thaumicconcilium | Thaumaturge's Drum | 2 | [VISCONDUCTOR] | [None]
DESTCRYSTAL | thaumicconcilium | Destabilized Crystal Cluster | 2 | [VISCONDUCTOR] | [ESSENTIACRYSTAL]
INFERNALBRACELET | thaumicconcilium | Infernal Bracelet | 2 | [TCBASES] | [TB.Bracelet.Iron, ROD_infernal, CAP_thaumium]
WARPEXTRACTIONFOCI | thaumicconcilium | Wand Focus: Warp Extraction | 3 | [RINGOFBLUSTERINGLIGHT] | [FOCUSPRIMAL, PRIMPEARL, REFLECTIONFOCI]
CRIMSONINITIATION | thaumicconcilium | Crimson Initiation | 1 | [PONTIFEXROBE] | [None]
BRAINLITTERING | thaumicconcilium | Brain Littering | 2 | [TCHORIZONS] | [infusionVat]
PRIMORDIALLIFE | thaumicconcilium | Primordial Life | 2 | [BRIGHTESTONE] | [None]
ETHEREALMANIPULATOR | thaumicconcilium | Wand Focus: Ethereal Manipulator | 2 | [HEXOFPREDICTABILITY] | [FOCUS_TELEKINESIS]
REDPOWEREDMIND | thaumicconcilium | Red-Powered Mind | 3 | [BRAINLITTERING, LIQUIDDEATH, ELDRITCHMINOR] | [CRYSTALBRAIN]
QUICKSILVERCRUCIBLE | thaumicconcilium | Quicksilver Reactor | 2 | [None] | [None]

=======[thaumicenergistics]=======
thaumicenergistics.TEESSVIBCMBR | thaumicenergistics | Vibration Chamber | 2 | [thaumicenergistics.TECORES] | [None]
thaumicenergistics.Pseudo.COREUSE | thaumicenergistics | Golem Core: Use | 1 | [None] | [None]
thaumicenergistics.TECERTUSDUPE | thaumicenergistics | Quartz Duplication | 1 | [thaumicenergistics.Pseudo.ALCHEMICALDUPLICATION] | [ALCHEMICALDUPLICATION]
thaumicenergistics.TEARCANETERM | thaumicenergistics | Arcane Crafting Terminal | 1 | [thaumicenergistics.TERESEARCH] | [None]
thaumicenergistics.Pseudo.DISTILESSENTIA | thaumicenergistics | Essentia Distillation | 1 | [None] | [None]
thaumicenergistics.Pseudo.VISPOWER | thaumicenergistics | Harnessing Vis | 1 | [None] | [None]
thaumicenergistics.TEARCANEASSEMBLER | thaumicenergistics | Arcane Assembler | 3 | [thaumicenergistics.TEVISINT, thaumicenergistics.Pseudo.SCEPTRE] | [thaumicenergistics.TEARCANETERM]
thaumicenergistics.TEINFPROV | thaumicenergistics | Infusion Provider | 3 | [thaumicenergistics.TEIO, thaumicenergistics.Pseudo.MIRROR, thaumicenergistics.Pseudo.INFUSION] | [MIRROR, INFUSION]
thaumicenergistics.TEFOCUSWRENCH | thaumicenergistics | Wand Focus: AE Wrench | 1 | [thaumicenergistics.Pseudo.FOCUSFIRE] | [None]
thaumicenergistics.TEIO | thaumicenergistics | Digi-sentia Transportation | 2 | [thaumicenergistics.TECORES, thaumicenergistics.Pseudo.TUBEFILTER] | [TUBEFILTER]
thaumicenergistics.TECORES | thaumicenergistics | Digi-sentia | 2 | [thaumicenergistics.TERESEARCH, thaumicenergistics.Pseudo.DISTILESSENTIA] | [DISTILESSENTIA]
thaumicenergistics.TERESEARCH | thaumicenergistics | Thaumic Energistics | 1 | [None] | [None]
thaumicenergistics.Pseudo.COREGATHER | thaumicenergistics | Golem Core: Gather | 1 | [None] | [None]
thaumicenergistics.Pseudo.TUBEFILTER | thaumicenergistics | Advanced Essentia Tubes | 1 | [None] | [None]
thaumicenergistics.TETHAUMGBOX | thaumicenergistics | Thaumium Gear Box | 1 | [thaumicenergistics.TEIRONGEARBOX, thaumicenergistics.Pseudo.COREUSE] | [COREUSE]
thaumicenergistics.TEVISINT | thaumicenergistics | Vis Relay Interface | 2 | [thaumicenergistics.TEARCANETERM, thaumicenergistics.Pseudo.VISPOWER] | [VISPOWER]
thaumicenergistics.Pseudo.INFUSION | thaumicenergistics | Infusion | 1 | [None] | [None]
thaumicenergistics.TESTORAGE | thaumicenergistics | Digi-sentia Storage | 2 | [thaumicenergistics.TERESEARCH, thaumicenergistics.Pseudo.DISTILESSENTIA, thaumicenergistics.Pseudo.WARDEDARCANA] | [DISTILESSENTIA]
thaumicenergistics.TEKNOWLEDGEINSCRIBER | thaumicenergistics | Knowledge Inscription | 1 | [thaumicenergistics.TEARCANEASSEMBLER] | [None]
thaumicenergistics.TEGOLEMWIFIBACKPACK | thaumicenergistics | Golem Wifi Backpack | 3 | [thaumicenergistics.TECORES, COREGATHER, thaumicenergistics.Pseudo.COREGATHER] | [None]
thaumicenergistics.Pseudo.ALCHEMICALDUPLICATION | thaumicenergistics | Alchemical Duplication | 1 | [None] | [None]
thaumicenergistics.TEIRONGEARBOX | thaumicenergistics | Iron Gear Box | 1 | [None] | [None]
thaumicenergistics.Pseudo.MIRROR | thaumicenergistics | Mirror Magic | 1 | [None] | [None]
thaumicenergistics.TEDISTILLATIONPATTERNENCODER | thaumicenergistics | Distillation Pattern Encoder | 3 | [thaumicenergistics.TEIO] | [thaumicenergistics.TEESSTERM]
thaumicenergistics.TEESSTERM | thaumicenergistics | Essentia Monitoring | 1 | [thaumicenergistics.TECORES] | [None]
thaumicenergistics.TEESSPROV | thaumicenergistics | Essentia Provider | 3 | [thaumicenergistics.TEIO] | [INFUSION, TUBEFILTER]
thaumicenergistics.Pseudo.WARDEDARCANA | thaumicenergistics | Warded Arcana | 1 | [None] | [None]
thaumicenergistics.Pseudo.FOCUSFIRE | thaumicenergistics | Wand Foci | 1 | [None] | [None]
thaumicenergistics.Pseudo.SCEPTRE | thaumicenergistics | Crafting Scepters | 1 | [None] | [None]

=======[thaumicexpansion]=======
PLAYERTRACKER | thaumicexpansion | Player Tracker | 1 | [THAUMICANALYZER] | [None]
DECOMPOSER | thaumicexpansion | Decomposer Upgrade | 1 | [THAUMICANALYZER] | [None]
THAUMICAPPARATUS | thaumicexpansion | tc.research_name.THAUMICAPPARATUS | 1 | [THAUMICANALYZER] | [None]
THAUMICANALYZER | thaumicexpansion | Thaumic Analyzer | 1 | [GOGGLES] | [None]

=======[thaumrev]=======
WARDENCLOTH | thaumrev | Wardencloth | 1 | [WARDENS] | [ENCHFABRIC]
ROD_wardencloth_staff | thaumrev | trvresearch.name.ROD_wardencloth_staff | 3 | [ROD_wardencloth] | [ROD_silverwood_staff]
EXCUBITURA | thaumrev | Excubitura | 1 | [WARDENS] | [None]
WARDENBOW | thaumrev | trvresearch.name.WARDENBOW | 3 | [WASLIEHAMMER] | [None]
WARDENS | thaumrev | Thaumic Wardens | 3 | [THAUMREV] | [None]
FOCUSPURITY | thaumrev | Wand Focus: Purity | 3 | [ROD_wardencloth] | [FOCUSWARDING]
CRIMSONHAT | thaumrev | trvresearch.name.CRIMSONHAT | 3 | [CRIMSONCULT] | [TINYHAT]
WARDENARMOR | thaumrev | The Armor | 3 | [WASLIEHAMMER] | [None]
CRIMSONCULT | thaumrev | The Crimson Cult | 3 | [THAUMREV] | [None]
ROD_wardencloth | thaumrev | trvresearch.name.ROD_wardencloth | 2 | [WARDENCLOTH] | [ROD_silverwood]
LORE2 | thaumrev | Learning The Ropes | 1 | [LORE1] | [None]
LORE3 | thaumrev | Not Making Sense | 1 | [LORE2] | [None]
CRYSTAL | thaumrev | Wardenic Crystal | 2 | [EXCUBITURA] | [None]
LORE4 | thaumrev | The Journey Begins | 1 | [LORE3] | [None]
FOCUSILLUMINATION | thaumrev | Wand Focus: Illumination | 2 | [ROD_wardencloth] | [FOCUSFIRE]
WASLIEHAMMER | thaumrev | Wesly's Hammer | 3 | [CRYSTAL, QUARTZ] | [ROD_wardencloth]
LORE1 | thaumrev | The Prologue | 1 | [WARDENS] | [None]
VOIDCLOTH | thaumrev | Voidcloth | 1 | [ELDRITCH] | [ENCHFABRIC]
WARDENAMULET | thaumrev | trvresearch.name.WARDENAMULET | 2 | [LORE4] | [None]
WARDENWEAPON | thaumrev | The Sword | 3 | [WASLIEHAMMER] | [None]
QUARTZ | thaumrev | Wardenic Quartz | 1 | [LORE4] | [None]
THAUMREV | thaumrev | Thaumic Revelations | 1 | [None] | [None]
ELDRITCH | thaumrev | The Eldritch | 3 | [THAUMREV] | [None]

=======[thaumores]=======
ENTROPICCLUSTERS | thaumores | Entropy Raw Clusters | 1 | [COPYENTROPICPROCESSING, RAWCLUSTERS] | [None]
INFUSEDENDSTONE | thaumores | Crystal Endstone | 1 | [COPYORE] | [None]
COPYALCHEMICALMANUFACTURE | thaumores | Alchemical Manufacture | 1 | [ALCHEMICALMANUFACTURE] | [None]
COPYELDRITCHMAJOR | thaumores | Eldritch Revelation | 1 | [ELDRITCHMAJOR] | [None]
COPYORE | thaumores | Ores | 1 | [ORE] | [None]
VISUALACUITY | thaumores | Sensitivity Thaum-miner | 2 | [COPYGOGGLES] | [None]
COPYPUREIRON | thaumores | Metal Purification | 1 | [PUREIRON] | [None]
INFUSEDNETHERRACK | thaumores | Crystal Netherrack | 1 | [COPYORE] | [None]
INFUSEDBEDROCK | thaumores | Crystal Bedrock | 1 | [COPYORE] | [None]
RAWCLUSTERS | thaumores | Raw Clusters | 3 | [INFUSEDBEDROCK, INFUSEDENDSTONE, INFUSEDNETHERRACK, COPYPUREIRON] | [None]
CRYSTALLIZERAWCLUSTERS | thaumores | Crystallization of Raw Clusters | 1 | [COPYALCHEMICALMANUFACTURE, RAWCLUSTERS] | [None]
WARPVISUALACUITY | thaumores | The distorted sight | 3 | [COPYELDRITCHMAJOR, VISUALACUITY] | [None]
COPYGOGGLES | thaumores | Goggles of Revealing | 1 | [GOGGLES] | [None]
COPYENTROPICPROCESSING | thaumores | Entropic Processing | 1 | [ENTROPICPROCESSING] | [None]

=======[twarden]=======
TWARDEN | twarden | Thaumic Wardens | 1 | [None] | [None]
ILLUMINATION | twarden | Wand Focus: Illumination | 1 | [None] | [FOCUSFIRE]
WARDENARMOR | twarden | The Armor | 3 | [WASLIEHAMMER] | [None]
LORE2 | twarden | Learning The Ropes | 3 | [LORE1] | [None]
LORE3 | twarden | Not Making Sense | 3 | [LORE2] | [None]
LORE4 | twarden | The Journey Begins | 3 | [LORE3] | [None]
WARDENWEAPON | twarden | The Sword | 3 | [WASLIEHAMMER] | [None]
EXUBITURA | twarden | Exubitura | 1 | [TWARDEN] | [None]
WARDENCRYSTAL | twarden | Wardenic Crystal | 2 | [TWARDEN] | [None]
INFUSEDQUARTZ | twarden | Wardenic Quartz | 2 | [TWARDEN] | [None]
WASLIEHAMMER | twarden | Wesly's Hammer | 3 | [LORE4] | [WARDENCRYSTAL, INFUSEDQUARTZ]
LORE1 | twarden | The Prologue | 3 | [TWARDEN] | [None]

=======[witchinggadgets]=======
ENCH_BACKSTAB | witchinggadgets | Enchantment: Backstabbing | 2 | [ENCH_STEALTH] | [None]
PRIMORDIALARMOR | witchinggadgets | Primordial Armor | 3 | [PRIMORDIALGEARSET, ARMORFORTRESS] | [None]
ENCH_STEALTH | witchinggadgets | Enchantment: Stealth | 2 | [WGFAKEINFUSIONENCHANTMENT] | [None]
ENCH_INVISIBLEGEAR | witchinggadgets | Enchantment: Translucency | 2 | [WGFAKEINFUSIONENCHANTMENT] | [None]
CALCULATOR | witchinggadgets | Arcane Abacus | 1 | [INFUSION] | [None]
PRIMORDIALGEARSET | witchinggadgets | Primal Revelation | 3 | [VOIDMETAL, WGFAKEPRIMPEARL] | [None]
ENDERBAG | witchinggadgets | Enderlinked Bag | 1 | [BAGOFTRICKS, INFUSION] | [None]
CLOAK_STORAGE | witchinggadgets | Cloak of Voluminous Pockets | 3 | [CLOAK] | [BAGOFTRICKS]
HUNGERBAG | witchinggadgets | Hungry Bag | 1 | [BAGOFTRICKS, HUNGRYCHEST] | [None]
ALCHEMICALTRANSMOGRIFY | witchinggadgets | Alchemical Transmogrification | 1 | [WGFAKEALCHEMICALMANUFACTURE] | [None]
WGFAKEPUREIRON | witchinggadgets | Metal Purification | 1 | [None] | [None]
WGFAKEBATHSALTS | witchinggadgets | Purifying Bath Salts | 1 | [None] | [None]
GEMCUTTING | witchinggadgets | Gem Cutting | 2 | [None] | [None]
VOIDBAG | witchinggadgets | Voidlinked Bag | 1 | [BAGOFTRICKS, WGFAKEELDRITCHMINOR] | [None]
TERRAFORMFOCUS_MUSHROOM | witchinggadgets | Terrestrial Focus: Mushroom Island | 2 | [TERRAFORMER] | [None]
TERRAFORMFOCUS_COLDTAIGA | witchinggadgets | Terrestrial Focus: Cold Taiga | 2 | [TERRAFORMER] | [None]
ETHEREALWALL | witchinggadgets | Ethereal Wall | 2 | [WGFAKEARCANESTONE] | [None]
ENCH_RIDEPROTECT | witchinggadgets | Enchantment: Throwoff | 2 | [WGFAKEINFUSIONENCHANTMENT] | [None]
TERRAFORMER | witchinggadgets | Thaumic Terraforming | 2 | [WGFAKECENTRIFUGE] | [None]
TERRAFORMFOCUS_TAINT | witchinggadgets | Terrestrial Focus: Tainted Lands | 2 | [TERRAFORMER, BOTTLETAINT] | [None]
STONEEXTRUDER | witchinggadgets | Thaumic Stone Extruder | 1 | [WGFAKEARCANESTONE, THAUMIUM] | [None]
WGFAKEALCHEMICALMANUFACTURE | witchinggadgets | Alchemical Manufacture | 1 | [None] | [None]
PURECINNABAR | witchinggadgets | Cinnabar Purification | 1 | [WGFAKEPUREIRON] | [None]
TERRAFORMFOCUS_JUNGLE | witchinggadgets | Terrestrial Focus: Jungle | 2 | [TERRAFORMER] | [None]
PRIMORDIALWEAPONRY | witchinggadgets | Primordial Weaponry | 3 | [PRIMORDIALGEARSET] | [None]
ROSEVINE | witchinggadgets | Rose Vines | 1 | [WGFAKEALCHEMICALMANUFACTURE] | [None]
METALLURGICPERFECTION_TRANSMUTATION | witchinggadgets | Metallurgic Perfection: Transmutation | 1 | [WGFAKETRANSIRON, TRANSGOLD, TRANSCOPPER, TRANSTIN, TRANSSILVER, TRANSLEAD] | [None]
AGEINGSTONE | witchinggadgets | Ageing Stone | 2 | [WGFAKEARCANESTONE] | [None]
ADVANCEDROBES | witchinggadgets | Bewitched Fleece | 3 | [WGFAKEENCHFABRIC, SPINNINGWHEEL] | [None]
WGFAKEJARLABEL | witchinggadgets | Warded Jars and Labels | 1 | [None] | [None]
WGFAKEELDRITCHMINOR | witchinggadgets | Eldritch Epiphany | 1 | [None] | [None]
CRYSTALCAPSULE | witchinggadgets | Crystal Capsule | 2 | [GEMCUTTING] | [None]
LABELLIB | witchinggadgets | Aspect Library | 2 | [WGFAKEJARLABEL] | [None]
EMPOWERPEARL | witchinggadgets | Pearl Revitalization | 1 | [WGFAKEPRIMPEARL] | [None]
MIRRORPUMP | witchinggadgets | Essentia Pump | 2 | [WGFAKEMIRRORESSENTIA] | [None]
WGBAUBLES | witchinggadgets | Witching Wearables | 1 | [THAUMIUM] | [None]
WGFAKEENCHFABRIC | witchinggadgets | Enchanted Fabric | 1 | [None] | [None]
SPINNINGWHEEL | witchinggadgets | Spinning | 1 | [None] | [None]
WGFAKECENTRIFUGE | witchinggadgets | Alchemical Centrifuge | 1 | [None] | [None]
CLOAK_SPECTRAL | witchinggadgets | Spectral Mantle | 3 | [CLOAK] | [INFUSION]
CLOAK_WOLF | witchinggadgets | Cloak of the Wolf | 3 | [CLOAK] | [None]
WGFAKEMIRRORESSENTIA | witchinggadgets | Essentia Mirrors | 1 | [None] | [None]
ENCH_UNVEILING | witchinggadgets | Enchantment: Unveiling | 2 | [WGFAKEINFUSIONENCHANTMENT] | [None]
WGFAKEPRIMPEARL | witchinggadgets | Primordial Pearl  | 1 | [None] | [None]
TERRAFORMFOCUS_DESERT | witchinggadgets | Terrestrial Focus: Desert | 2 | [TERRAFORMER] | [None]
CLOAK | witchinggadgets | Cloak | 2 | [None] | [ENCHFABRIC]
LABYRINTHSTRING | witchinggadgets | Guiding Thread | 1 | [INFUSION] | [None]
CLOAKKAMA | witchinggadgets | Kama | 1 | [WGBAUBLES, CLOAK] | [None]
WGPOTIONS | witchinggadgets | Status Effects | 1 | [None] | [None]
WGFAKETRANSIRON | witchinggadgets | Metal Transmutation | 1 | [None] | [None]
METALLURGICPERFECTION_CLUSTERS | witchinggadgets | Metallurgic Perfection: Purification | 1 | [WGFAKEPUREIRON, PUREGOLD, PURECOPPER, PURETIN, PURESILVER, PURELEAD, PURECINNABAR] | [None]
TERRAFORMFOCUS_HELL | witchinggadgets | Terrestrial Focus: Hell | 2 | [TERRAFORMER] | [None]
INFERNALBLASTFURNACE | witchinggadgets | Infernal Blast Furnace | 2 | [WGFAKEINFERNALFURNACE] | [None]
SCANCAMERA | witchinggadgets | Thaumic Iconograph | 2 | [None] | [None]
WGFAKEINFUSIONENCHANTMENT | witchinggadgets | Infusion Enchantment | 1 | [None] | [None]
PRIMORDIALGLOVE | witchinggadgets | Primordial Gauntlet | 2 | [VOIDMETAL, PRIMORDIALGEARSET, WGFAKEPRIMPEARL] | [None]
WGFAKEARCANESTONE | witchinggadgets | Arcane Stone | 1 | [None] | [None]
WGFAKEINFERNALFURNACE | witchinggadgets | Infernal Furnace | 1 | [None] | [None]
BAGOFTRICKS | witchinggadgets | Bag of Tricks | 1 | [SPINNINGWHEEL] | [None]
SAUNASTOVE | witchinggadgets | Thaumic Sauna Stove | 1 | [WGFAKEBATHSALTS] | [None]

